John_Adams	deathPlace	Quincy,_Massachusetts	True
Adam_Smith	deathPlace	Edinburgh	True
Hugo_Chávez	deathPlace	Caracas	True
Chet_Atkins	deathPlace	Nashville,_Tennessee	True
Harry_S._Truman	deathPlace	Kansas_City,_Missouri	True
Kurt_Cobain	deathPlace	Seattle	True
Roscoe_Arbuckle	deathPlace	New_York_City	True
Thelonious_Monk	deathPlace	Englewood,_New_Jersey	True
John_Lee_Hooker	deathPlace	Los_Altos,_California	True
Roald_Dahl	deathPlace	Oxford	True
Robert_Menzies	deathPlace	Melbourne	True
Arthur_Ashe	deathPlace	New_York_City	True
William_McKinley	deathPlace	Buffalo,_New_York	True
Franklin_D._Roosevelt	deathPlace	Warm_Springs,_Georgia	True
L._Sprague_de_Camp	deathPlace	Plano,_Texas	True
Charles_Mingus	deathPlace	Cuernavaca	True
Jefferson_Davis	deathPlace	New_Orleans	True
Fred_Astaire	deathPlace	Los_Angeles	True
Burt_Lancaster	deathPlace	Los_Angeles	True
Tupac_Shakur	deathPlace	Las_Vegas	True
Curtis_Mayfield	deathPlace	Roswell,_Georgia	True
Slobodan_Milošević	deathPlace	The_Hague	True
Bo_Diddley	deathPlace	Archer,_Florida	True
Henry_Wadsworth_Longfellow	deathPlace	Cambridge,_Massachusetts	True
Harold_Lloyd	deathPlace	Beverly_Hills,_California	True
Herbert_Hoover	deathPlace	New_York_City	True
Elizabeth_Taylor	deathPlace	Los_Angeles	True
John_A._Macdonald	deathPlace	Ottawa	True
John_F._Kennedy	deathPlace	Dallas	True
Donna_Summer	deathPlace	Naples,_Florida	True
Heinrich_Gustav_Reichenbach	deathPlace	Hamburg	True
George_Jones	deathPlace	Nashville,_Tennessee	True
John_Wayne	deathPlace	Los_Angeles	True
Herman_Melville	deathPlace	New_York_City	True
Hermann_Göring	deathPlace	Nuremberg	True
Gene_Kelly	deathPlace	Beverly_Hills,_California	True
George_Balanchine	deathPlace	New_York_City	True
James_Monroe	deathPlace	New_York_City	True
Robert_Mitchum	deathPlace	Santa_Barbara,_California	True
Humphrey_Bogart	deathPlace	Los_Angeles	True
Pierre_Trudeau	deathPlace	Montreal	True
Billy_Wilder	deathPlace	Beverly_Hills,_California	True
Walt_Disney	deathPlace	Burbank,_California	True
Jerry_Goldsmith	deathPlace	Beverly_Hills,_California	True
Sarah_Vaughan	deathPlace	Hidden_Hills,_California	True
Miles_Davis	deathPlace	Santa_Monica,_California	True
Kurt_Vonnegut	deathPlace	New_York_City	True
Steve_Jobs	deathPlace	Palo_Alto,_California	True
Louis_IX_of_France	deathPlace	Tunis	True
John_C._Frémont	deathPlace	New_York_City	True
Roy_Orbison	deathPlace	Hendersonville,_Tennessee	True
Anthony_Quinn	deathPlace	Boston	True
John_Diefenbaker	deathPlace	Ottawa	True
Akbar	deathPlace	Agra	True
Ira_Gershwin	deathPlace	Beverly_Hills,_California	True
Josip_Broz_Tito	deathPlace	Ljubljana	True
Benjamin_Harrison	deathPlace	Indianapolis	True
Hank_Williams	deathPlace	Oak_Hill,_West_Virginia	True
Andrew_Johnson	deathPlace	Elizabethton,_Tennessee	True
Jonathan_Swift	deathPlace	Dublin	True
Hal_Roach	deathPlace	Los_Angeles	True
Walt_Whitman	deathPlace	Camden,_New_Jersey	True
Corazon_Aquino	deathPlace	Makati	True
Otis_Redding	deathPlace	Madison,_Wisconsin	True
Richard_Rodgers	deathPlace	New_York_City	True
Kurt_Aland	deathPlace	Münster	True
Johnny_Cash	deathPlace	Nashville,_Tennessee	True
Robert_F._Kennedy	deathPlace	Los_Angeles	True
Philip_K._Dick	deathPlace	Santa_Ana,_California	True
Chris_Benoit	deathPlace	Fayetteville,_Georgia	True
Errol_Flynn	deathPlace	Vancouver	True
Franklin_Pierce	deathPlace	Concord,_New_Hampshire	True
Count_Basie	deathPlace	Hollywood,_Florida	True
Rutherford_B._Hayes	deathPlace	Fremont,_Ohio	True
Edgar_Allan_Poe	deathPlace	Baltimore	True
Gabriel_Lippmann	award	Nobel_Prize_in_Physics	True
William_Golding	award	Nobel_Prize_in_Literature	True
Frans_Eemil_Sillanpää	award	Nobel_Prize_in_Literature	True
Walther_Bothe	award	Nobel_Prize_in_Physics	True
Ivan_Bunin	award	Nobel_Prize_in_Literature	True
Rudyard_Kipling	award	Nobel_Prize_in_Literature	True
Albert_Camus	award	Nobel_Prize_in_Literature	True
Harry_Martinson	award	Nobel_Prize_in_Literature	True
Carlos_Filipe_Ximenes_Belo	award	Nobel_Peace_Prize	True
Henryk_Sienkiewicz	award	Nobel_Prize_in_Literature	True
J._M._Coetzee	award	Nobel_Prize_in_Literature	True
Svante_Arrhenius	award	Nobel_Prize_in_Chemistry	True
Michail_Aleksandrovich_Sholokhov	award	Nobel_Prize_in_Literature	True
Charles_Glover_Barkla	award	Nobel_Prize_in_Physics	True
George_Minot	award	Nobel_Prize_in_Physiology_or_Medicine	True
Wilhelm_Röntgen	award	Nobel_Prize_in_Physics	True
Albert_Einstein	award	Nobel_Prize_in_Physics	True
Anatole_France	award	Nobel_Prize_in_Literature	True
Nils_Gustaf_Dalén	award	Nobel_Prize_in_Physics	True
Shmuel_Yosef_Agnon	award	Nobel_Prize_in_Literature	True
Giosuè_Carducci	award	Nobel_Prize_in_Literature	True
Johannes_Stark	award	Nobel_Prize_in_Physics	True
William_Faulkner	award	Nobel_Prize_in_Literature	True
Gao_Xingjian	award	Nobel_Prize_in_Literature	True
John_Steinbeck	award	Nobel_Prize_in_Literature	True
Jacinto_Benavente	award	Nobel_Prize_in_Literature	True
Wisława_Szymborska	award	Nobel_Prize_in_Literature	True
Halldór_Laxness	award	Nobel_Prize_in_Literature	True
Romain_Rolland	award	Nobel_Prize_in_Literature	True
Gerhart_Hauptmann	award	Nobel_Prize_in_Literature	True
Henry_Dunant	award	Nobel_Peace_Prize	True
Intergovernmental_Panel_on_Climate_Change	award	Nobel_Peace_Prize	True
John_William_Strutt	award	Nobel_Prize_in_Physics	True
Verner_von_Heidenstam	award	Nobel_Prize_in_Literature	True
John_Galsworthy	award	Nobel_Prize_in_Literature	True
George_Seferis	award	Nobel_Prize_in_Literature	True
Theodor_Mommsen	award	Nobel_Prize_in_Literature	True
Heinrich_Böll	award	Nobel_Prize_in_Literature	True
Derek_Walcott	award	Nobel_Prize_in_Literature	True
Czesław_Miłosz	award	Nobel_Prize_in_Literature	True
William_Butler_Yeats	award	Nobel_Prize_in_Literature	True
André_Gide	award	Nobel_Prize_in_Literature	True
Robert_Hofstadter	award	Nobel_Prize_in_Physics	True
James_Franck	award	Nobel_Prize_in_Physics	True
Toni_Morrison	award	Nobel_Prize_in_Literature	True
Yasunari_Kawabata	award	Nobel_Prize_in_Literature	True
Herbert_A._Hauptman	award	Nobel_Prize_in_Chemistry	True
Sigrid_Undset	award	Nobel_Prize_in_Literature	True
Paul_Heyse	award	Nobel_Prize_in_Literature	True
Robert_Andrews_Millikan	award	Nobel_Prize_in_Physics	True
Maurice_Maeterlinck	award	Nobel_Prize_in_Literature	True
Jimmy_Carter	award	Nobel_Peace_Prize	True
Karl_von_Frisch	award	Nobel_Prize_in_Physiology_or_Medicine	True
François_Mauriac	award	Nobel_Prize_in_Literature	True
Thomas_Mann	award	Nobel_Prize_in_Literature	True
Vicente_Aleixandre	award	Nobel_Prize_in_Literature	True
Gabriela_Mistral	award	Nobel_Prize_in_Literature	True
Johannes_Diderik_van_der_Waals	award	Nobel_Prize_in_Physics	True
Władysław_Stanisław_Reymont	award	Nobel_Prize_in_Literature	True
François_Jacob	award	Nobel_Prize_in_Physiology_or_Medicine	True
Antoine_Henri_Becquerel	award	Nobel_Prize_in_Physics	True
José_Saramago	award	Nobel_Prize_in_Literature	True
Luigi_Pirandello	award	Nobel_Prize_in_Literature	True
Arno_Allan_Penzias	award	Nobel_Prize_in_Physics	True
Patrick_White	award	Nobel_Prize_in_Literature	True
Miguel_Ángel_Asturias	award	Nobel_Prize_in_Literature	True
Max_von_Laue	award	Nobel_Prize_in_Physics	True
Sinclair_Lewis	award	Nobel_Prize_in_Literature	True
Roger_Martin_du_Gard	award	Nobel_Prize_in_Literature	True
Herbert_Spencer_Gasser	award	Nobel_Prize_in_Physiology_or_Medicine	True
Joseph_John_Thomson	award	Nobel_Prize_in_Physics	True
Dario_Fo	award	Nobel_Prize_in_Literature	True
International_Atomic_Energy_Agency	award	Nobel_Peace_Prize	True
Juan_Ramón_Jiménez	award	Nobel_Prize_in_Literature	True
Kenzaburō_Ōe	award	Nobel_Prize_in_Literature	True
Elan_Corporation	subsidiary	Athena_Neurosciences	True
Manhattan_Associates	subsidiary	Evant,_Inc.	True
Selectica	subsidiary	Determine_Software	True
Oracle_Corporation	subsidiary	Bharosa	True
Biomet	subsidiary	Interpore	True
Electronic_Arts	subsidiary	Westwood_Studios	True
Yahoo!	subsidiary	Zimbra	True
Adobe_Systems	subsidiary	Macromedia	True
Ascend_Communications	subsidiary	Cascade_Communications	True
Silicon_Graphics,_Inc.	subsidiary	Cray_Research,_Inc.	True
Norfolk_Southern_Railway	subsidiary	Conrail	True
Oracle_Corporation	subsidiary	Interlace_Systems	True
Oracle_Corporation	subsidiary	LogicalApps	True
SunGard	subsidiary	Aceva_Technologies	True
LSI_Corporation	subsidiary	C-Cube_Microsystems	True
SRI_International	subsidiary	PacketHop	True
iUpload	subsidiary	WebPartz	True
Det_Norske_Veritas	subsidiary	Tireno	True
Oracle_Corporation	subsidiary	Tangosol	True
Oracle_Corporation	subsidiary	Demantra	True
EMC_Corporation	subsidiary	Documentum	True
Sun_Microsystems	subsidiary	CenterRun	True
Det_Norske_Veritas	subsidiary	CIBIT	True
Intel_Corporation	subsidiary	Shiva	True
The_Walt_Disney_Company	subsidiary	Fox_Kids	True
Terra_Lycos	subsidiary	Quote.com	True
Neighborhood_America	subsidiary	MOVO_Mobile	True
Yahoo!	subsidiary	BlueLithium	True
Netscape	subsidiary	Collabra_Software	True
Hewlett-Packard	subsidiary	Snapfish	True
Ascend_Communications	subsidiary	Morning_Star_Technologies	True
IBM	subsidiary	Tivoli_Systems,_Inc.	True
BEA_Systems	subsidiary	Plumtree_Software	True
Cisco_Systems,_Inc.	subsidiary	Clarity_Wireless,_Inc	True
Dell	subsidiary	EqualLogic	True
IFM_Renewable_Energy	subsidiary	Pacific_Hydro	True
eBay	subsidiary	Billpoint	True
IBM	subsidiary	IBM_Internet_Security_Systems	True
ABC_Family_Worldwide_Inc.	subsidiary	Television_South	True
Phillips_Electronics_NV	subsidiary	VLSI_Technology	True
Oracle_Corporation	subsidiary	MetaSolv_Software	True
nCircle_Network_Security,_Inc.	subsidiary	Cambia_Security,_Inc.	True
GlaxoSmithKline	subsidiary	Corixa	True
Yahoo!	subsidiary	Overture	True
Infor	subsidiary	Epiphany	True
NBC	subsidiary	Oxygen_media	True
eBay	subsidiary	PayPal	True
Johnson_&_Johnson	subsidiary	Heartport_Inc.	True
TiVo,_Inc.	subsidiary	Strangeberry	True
BMC_Software	subsidiary	Marimba	True
Hewlett-Packard	subsidiary	Logoworks	True
Yahoo!	subsidiary	eGroups	True
Cisco_Systems,_Inc.	subsidiary	Stratum_One	True
ByteMobile	subsidiary	Daedalus	True
Lucent	subsidiary	INS	True
Oracle_Corporation	subsidiary	Hyperion_Solutions	True
Applied_HealthCare	subsidiary	Medicode	True
EchoStar_Communications_Corporation	subsidiary	Sling_Media_Inc.	True
ADC_Telecommunications	subsidiary	LGC_Wireless	True
Mascoma_Corporation	subsidiary	Celsys_Biofuels_Inc.	True
Motorola	subsidiary	Terayon	True
Oracle_Corporation	subsidiary	Sunopsis	True
Oracle_Corporation	subsidiary	Moniforce	True
Platial	subsidiary	Frappr	True
BabyCenter	subsidiary	Maya's_Mom	True
SSA_Global_Technologies	subsidiary	Walker_Interactive_Systems	True
Saba_Software	subsidiary	THINQ_Learning_Solutions	True
Oracle_Corporation	subsidiary	Sigma_Dynamics	True
Oracle_Corporation	subsidiary	Portal_Software	True
Sybase	subsidiary	Mobile_365	True
Oracle_Corporation	subsidiary	SPL_WorldGroup	True
Synopsys	subsidiary	Integrated_Systems_Engineering_AG	True
Oracle_Corporation	subsidiary	Context_Media	True
Emerson_Electric_Company	subsidiary	Cooligy	True
CA_Inc.	subsidiary	Interlink_Computer_Sciences	True
Kaysone_Phomvihane	office	Laos	True
Jelle_Zijlstra	office	Netherlands	True
Pedro_Pires	office	Cape_Verde	True
Golda_Meir	office	Israel	True
José_Manuel_Barroso	office	Portugal	True
Jacques_Chirac	office	France	True
Elisabeth_Domitien	office	Central_African_Republic	True
Kalevi_Sorsa	office	Finland	True
José_Ramos-Horta	office	East_Timor	True
Jean_Chrétien	office	Canada	True
Josip_Broz_Tito	office	Yugoslavia	True
Pierre_Trudeau	office	Canada	True
Gordon_Brown	office	United_Kingdom	True
Manuel_Azaña	office	Spain	True
Gamal_Abdel_Nasser	office	Egypt	True
Mahendra_Chaudhry	office	Fiji	True
Aimo_Cajander	office	Finland	True
José_María_Aznar	office	Spain	True
Gaston_Eyskens	office	Belgium	True
Jean_Casimir-Perier	office	France	True
Saddam_Hussein	office	Iraq	True
Dileita_Mohamed_Dileita	office	Djibouti	True
Ásgeir_Ásgeirsson	office	Iceland	True
Ionatana_Ionatana	office	Tuvalu	True
Kakuei_Tanaka	office	Japan	True
Mahathir_Mohamad	office	Malaysia	True
Poul_Nyrup_Rasmussen	office	Denmark	True
Édith_Cresson	office	France	True
Paul_van_Zeeland	office	Belgium	True
Toshiki_Kaifu	office	Japan	True
Ryutaro_Hashimoto	office	Japan	True
Vazgen_Sargsyan	office	Armenia	True
Wilfried_Martens	office	Belgium	True
Adolphe_Thiers	office	France	True
Pierre_Harmel	office	Belgium	True
Kiichi_Miyazawa	office	Japan	True
Stjepan_Mesić	office	Croatia	True
Keizō_Obuchi	office	Japan	True
Zine_El_Abidine_Ben_Ali	office	Tunisia	True
Ruud_Lubbers	office	Netherlands	True
John_Sparrow_David_Thompson	office	Canada	True
Georges_Pompidou	office	France	True
Ariel_Sharon	office	Israel	True
Barend_Biesheuvel	office	Netherlands	True
Anwar_Sadat	office	Egypt	True
Osachi_Hamaguchi	office	Japan	True
Harold_Wilson	office	United_Kingdom	True
Maria_das_Neves	office	São_Tomé_and_Príncipe	True
Mikhail_Kasyanov	office	Russia	True
Jan_Peter_Balkenende	office	Netherlands	True
Piet_de_Jong	office	Netherlands	True
Mário_Soares	office	Portugal	True
Wilfrid_Laurier	office	Canada	True
Robert_Bond	office	Dominion_of_Newfoundland	True
Jo_Cals	office	Netherlands	True
Bharrat_Jagdeo	office	Guyana	True
Benazir_Bhutto	office	Pakistan	True
P._W._Botha	office	South_Africa	True
Abd_Al-Rahman_Al-Gillani	office	Iraq	True
Abdullah_Ahmad_Badawi	office	Malaysia	True
Abdul-Wahab_Mirjan	office	Iraq	True
Menachem_Begin	office	Israel	True
Louis_Botha	office	South_Africa	True
Tsutomu_Hata	office	Japan	True
Tunku_Abdul_Rahman	office	Malaysia	True
Alec_Douglas-Home	office	United_Kingdom	True
Lauri_Ingman	office	Finland	True
Naji_Shawkat	office	Iraq	True
Baburam_Bhattarai	office	Nepal	True
Abdul_Razak_Hussein	office	Malaysia	True
Yitzhak_Shamir	office	Israel	True
Ahmed_Ouyahia	office	Algeria	True
Jacques_Santer	office	Luxembourg	True
Jean-Luc_Dehaene	office	Belgium	True
Jigme_Thinley	office	Bhutan	True
Ian_Mahinmi	team	Dallas_Mavericks	True
Gerald_Green	team	Boston_Celtics	True
Chris_Kaman	team	Los_Angeles_Clippers	True
Elton_Brand	team	Los_Angeles_Clippers	True
Deron_Williams	team	Utah_Jazz	True
Al_Jefferson	team	Utah_Jazz	True
Tyson_Chandler	team	Chicago_Bulls	True
Martell_Webster	team	Minnesota_Timberwolves	True
Pau_Gasol	team	Memphis_Grizzlies	True
Al_Jefferson	team	Boston_Celtics	True
Metta_World_Peace	team	Houston_Rockets	True
Rasheed_Wallace	team	Atlanta_Hawks	True
Zach_Randolph	team	New_York_Knicks	True
Mike_Dunleavy,_Jr.	team	Indiana_Pacers	True
Channing_Frye	team	New_York_Knicks	True
Kyle_Korver	team	Philadelphia_76ers	True
Gerald_Green	team	Houston_Rockets	True
Raymond_Felton	team	New_York_Knicks	True
Tyson_Chandler	team	Charlotte_Bobcats	True
Gerald_Wallace	team	Charlotte_Bobcats	True
Ray_Allen	team	Boston_Celtics	True
J._R._Smith	team	New_Orleans_Hornets	True
Richard_Jefferson	team	San_Antonio_Spurs	True
Jason_Terry	team	Boston_Celtics	True
Derek_Fisher	team	Dallas_Mavericks	True
Jamal_Crawford	team	New_York_Knicks	True
Ben_Gordon	team	Chicago_Bulls	True
John_Lucas_III	team	Houston_Rockets	True
Derek_Fisher	team	Golden_State_Warriors	True
John_Lucas_III	team	Chicago_Bulls	True
Mike_Miller_(basketball_player)	team	Minnesota_Timberwolves	True
Metta_World_Peace	team	Indiana_Pacers	True
Shaun_Livingston	team	Charlotte_Bobcats	True
Elton_Brand	team	Dallas_Mavericks	True
Shaun_Livingston	team	Los_Angeles_Clippers	True
Derek_Fisher	team	Los_Angeles_Lakers	True
Samuel_Dalembert	team	Sacramento_Kings	True
Dwight_Howard	team	Orlando_Magic	True
Shawn_Marion	team	Miami_Heat	True
Kenyon_Martin	team	Los_Angeles_Clippers	True
Shaun_Livingston	team	Oklahoma_City_Thunder	True
Nazr_Mohammed	team	Oklahoma_City_Thunder	True
Marvin_Williams	team	Atlanta_Hawks	True
Kwame_Brown	team	Los_Angeles_Lakers	True
Andrei_Kirilenko	team	Utah_Jazz	True
Kwame_Brown	team	Golden_State_Warriors	True
Jamal_Crawford	team	Atlanta_Hawks	True
LeBron_James	team	Cleveland_Cavaliers	True
Emeka_Okafor	team	Charlotte_Bobcats	True
Jason_Richardson	team	Charlotte_Bobcats	True
Chauncey_Billups	team	New_York_Knicks	True
Kwame_Brown	team	Detroit_Pistons	True
Nazr_Mohammed	team	Detroit_Pistons	True
Shaun_Livingston	team	Cleveland_Cavaliers	True
Carlos_Delfino	team	Detroit_Pistons	True
Steve_Blake	team	Portland_Trail_Blazers	True
Chris_Kaman	team	Dallas_Mavericks	True
Andris_Biedriņš	team	Golden_State_Warriors	True
Raymond_Felton	team	Portland_Trail_Blazers	True
Chauncey_Billups	team	Detroit_Pistons	True
Luis_Scola	team	Houston_Rockets	True
Kyle_Korver	team	Chicago_Bulls	True
Mike_Miller_(basketball_player)	team	Miami_Heat	True
Monta_Ellis	team	Golden_State_Warriors	True
Andrew_Bynum	team	Los_Angeles_Lakers	True
Steve_Blake	team	Portland_Trail_Blazers	True
Tyler_Hansbrough	team	Indiana_Pacers	True
Carlos_Delfino	team	Houston_Rockets	True
Kevin_Garnett	team	Boston_Celtics	True
Tony_Allen_(basketball)	team	Boston_Celtics	True
Nazr_Mohammed	team	New_York_Knicks	True
Shane_Battier	team	Houston_Rockets	True
Jason_Richardson	team	Orlando_Magic	True
Carlos_Boozer	team	Utah_Jazz	True
Rasheed_Wallace	team	Boston_Celtics	True
Edward_Bulwer-Lytton,_1st_Baron_Lytton	author	Vril	True
Mary_Shelley	author	Frankenstein	True
Michael_F._Flynn	author	Fallen_Angels	True
Kate_Wilhelm	author	Where_Late_the_Sweet_Birds_Sang	True
Walter_Jon_Williams	author	Aristoi	True
Gregory_Keyes	author	A_Calculus_of_Angels	True
Harlan_Ellison	author	Again,_Dangerous_Visions	True
Ian_Stewart	author	Wheelers	True
John_Varley	author	Immodest_Proposals	True
William_Tenn	author	Immodest_Proposals	True
Alexander_Jablokov	author	The_Breath_of_Suspension	True
Ian_R._MacLeod	author	Voyages_by_Starlight	True
Gentry_Lee	author	The_Garden_of_Rama	True
Poul_Anderson	author	The_Boat_of_a_Million_Years	True
Edwin_Balmer	author	When_Worlds_Collide	True
Kurt_Vonnegut	author	Slaughterhouse-Five	True
Kevin_Dilmore	author	Summon_the_Thunder	True
S._Fowler_Wright	author	The_Throne_of_Saturn	True
Jean_Bonnefoy	author	So_Long,_and_Thanks_for_All_the_Fish	True
Iain_Banks	author	Whit	True
Mordecai_Roshwald	author	Level_7	True
Tony_Rothman	author	The_World_Is_Round	True
Gene_Wolfe	author	The_Urth_of_the_New_Sun	True
Brian_Aldiss	author	Non-Stop	True
Walter_M._Miller,_Jr.	author	A_Canticle_for_Leibowitz	True
David_Gerrold	author	When_Harlie_Was_One	True
Frank_Herbert	author	Heretics_of_Dune	True
Kim_Newman	author	Back_in_the_USSA	True
Barry_N._Malzberg	author	Beyond_Apollo	True
H._G._Wells	author	The_Wheels_of_Chance	True
Philip_K._Dick	author	Do_Androids_Dream_of_Electric_Sheep?	True
Joan_Slonczewski	author	A_Door_into_Ocean	True
Joe_Haldeman	author	The_Forever_War	True
Mary_Rosenblum	author	Synthesis_&_Other_Virtual_Realities	True
William_Gibson	author	Neuromancer	True
Daniel_Keyes	author	Flowers_for_Algernon	True
Kim_Stanley_Robinson	author	Fifty_Degrees_Below	True
Ira_Levin	author	This_Perfect_Day	True
Orson_Scott_Card	author	Shadow_of_the_Hegemon	True
Yevgeny_Zamyatin	author	We	True
Larry_Niven	author	The_Integral_Trees	True
Doris_Lessing	author	The_Sentimental_Agents_in_the_Volyen_Empire	True
Robert_Silverberg	author	A_Time_of_Changes	True
Thomas_M._Disch	author	334	True
Robert_Louis_Stevenson	author	Strange_Case_of_Dr_Jekyll_and_Mr_Hyde	True
Rodman_Philbrick	author	The_Last_Book_in_the_Universe	True
Jules_Verne	author	The_Begum's_Fortune	True
Alfred_Bester	author	The_Demolished_Man	True
Robert_Sheckley	author	Options	True
Terry_Pratchett	author	Good_Omens	True
Roger_Zelazny	author	Lord_of_Light	True
Arthur_Conan_Doyle	author	The_Poison_Belt	True
Peter_F._Hamilton	author	The_Neutronium_Alchemist	True
David_Brin	author	The_Postman	True
Michael_Shea	author	Polyphemus	True
Isaac_Asimov	author	The_Caves_of_Steel	True
Garth_Nix	author	Castle	True
Harry_Turtledove	author	Worldwar:_Upsetting_the_Balance	True
Jack_Dann	author	Wandering_Stars	True
C._S._Lewis	author	Out_of_the_Silent_Planet	True
Michael_Swanwick	author	Jack_Faust	True
Neal_Stephenson	author	The_Big_U	True
Russell_Hoban	author	Riddley_Walker	True
C._J._Cherryh	author	The_Collected_Short_Fiction_of_C._J._Cherryh	True
Fritz_Leiber	author	The_Wanderer	True
Mark_Twain	author	A_Connecticut_Yankee_in_King_Arthur's_Court	True
Simon_Clark	author	The_Night_of_the_Triffids	True
John_Barnes	author	Orbital_Resonance	True
Angela_Carter	author	The_Passion_of_New_Eve	True
Carl_Sagan	author	Contact	True
Stanisław_Lem	author	Return_from_the_Stars	True
Kathy_Tyers	author	The_Truce_at_Bakura	True
Stephen_King	author	Carrie	True
Roger_MacBride_Allen	author	The_War_Machine	True
Edwin_Abbott_Abbott	author	Flatland:_A_Romance_of_Many_Dimensions	True
Om_Shanti_Om	starring	Yuvika_Chaudhary	True
The_Aristocats	starring	Hermione_Gingold	True
The_Right_Stuff_(film)	starring	Lance_Henriksen	True
Camp_Rock	starring	Demi_Lovato	True
Edward_Scissorhands	starring	Kathy_Baker	True
A_Hard_Day's_Night_(film)	starring	Maggie_d'Abo	True
A_Hard_Day's_Night_(film)	starring	John_Junkin	True
Ed_Wood_(film)	starring	Jeffrey_Jones	True
Mean_Girls	starring	Lacey_Chabert	True
On_the_Waterfront	starring	Marlon_Brando	True
The_Right_Stuff_(film)	starring	Harry_Shearer	True
High_School_Musical_2	starring	Ashley_Tisdale	True
The_Right_Stuff_(film)	starring	Ed_Harris	True
The_Right_Stuff_(film)	starring	Jeff_Goldblum	True
2012_(film)	starring	Oliver_Platt	True
Camp_Rock	starring	Joe_Jonas	True
2012_(film)	starring	Danny_Glover	True
Godzilla_(1998_film)	starring	Matthew_Broderick	True
Camp_Rock	starring	Maria_Canals_Barrera	True
Mean_Girls	starring	Lizzy_Caplan	True
Clerks	starring	Marilyn_Ghigliotti	True
Predator_(film)	starring	Carl_Weathers	True
2012_(film)	starring	Amanda_Peet	True
Superbad_(film)	starring	Seth_Rogen	True
Last_Action_Hero	starring	Bridgette_Wilson	True
High_School_Musical_2	starring	Lucas_Grabeel	True
Ghostbusters_II	starring	Ernie_Hudson	True
Om_Shanti_Om	starring	Shah_Rukh_Khan	True
Mad_Max	starring	Hugh_Keays-Byrne	True
A_Hard_Day's_Night_(film)	starring	The_Beatles	True
Love_Actually	starring	Colin_Firth	True
Austin_Powers:_The_Spy_Who_Shagged_Me	starring	Robert_Wagner	True
Ghostbusters_II	starring	Bill_Murray	True
The_Aristocats	starring	Sterling_Holloway	True
Ed_Wood_(film)	starring	Lisa_Marie_(actress)	True
Last_Action_Hero	starring	Anthony_Quinn	True
Camp_Rock	starring	Alyson_Stoner	True
The_Right_Stuff_(film)	starring	Barbara_Hershey	True
Austin_Powers:_The_Spy_Who_Shagged_Me	starring	Mike_Myers_(actor)	True
Seven_(film)	starring	Brad_Pitt	True
Kill_Bill	starring	Uma_Thurman	True
Superbad_(film)	starring	Jonah_Hill	True
Last_Action_Hero	starring	Art_Carney	True
Om_Shanti_Om	starring	Deepika_Padukone	True
The_Right_Stuff_(film)	starring	Scott_Glenn	True
Edward_Scissorhands	starring	Alan_Arkin	True
Love_Actually	starring	Laura_Linney	True
A_Hard_Day's_Night_(film)	starring	Wilfrid_Brambell	True
Kill_Bill	starring	Gordon_Liu	True
Clerks	starring	Kevin_Smith	True
A_Hard_Day's_Night_(film)	starring	Paul_McCartney	True
The_Aristocats	starring	Phil_Harris	True
The_Aristocats	starring	Eva_Gabor	True
Godzilla_(1998_film)	starring	Kevin_Dunn	True
Edward_Scissorhands	starring	Dianne_Wiest	True
High_School_Musical_2	starring	Vanessa_Hudgens	True
Ed_Wood_(film)	starring	Patricia_Arquette	True
2012_(film)	starring	Woody_Harrelson	True
Last_Action_Hero	starring	Tom_Noonan	True
Kill_Bill	starring	Lucy_Liu	True
Clerks	starring	Jason_Mewes	True
Love_Actually	starring	Alan_Rickman	True
Austin_Powers:_The_Spy_Who_Shagged_Me	starring	Will_Ferrell	True
Kill_Bill	starring	Daryl_Hannah	True
Mean_Girls	starring	Tina_Fey	True
Ghostbusters_II	starring	Rick_Moranis	True
Mad_Max	starring	Tim_Burns	True
Camp_Rock	starring	Nick_Jonas	True
Predator_(film)	starring	Kevin_Peter_Hall	True
Love_Actually	starring	Hugh_Grant	True
Last_Action_Hero	starring	F._Murray_Abraham	True
Godzilla_(1998_film)	starring	Harry_Shearer	True
Mad_Max	starring	Mel_Gibson	True
Love_Actually	starring	Martine_McCutcheon	True
Predator_(film)	starring	Arnold_Schwarzenegger	True
Kate_Winslet	spouse	Sam_Mendes	True
Jeffrey_Dean_Morgan	spouse	Mary-Louise_Parker	True
Saul_Williams	spouse	Persia_White	True
Peter_Crone	spouse	Maxine_Bahns	True
Howard_K._Stern	spouse	Anna_Nicole_Smith	True
Joshua	spouse	Anna_Tsuchiya	True
Raza_Jaffrey	spouse	Miranda_Raison	True
Jenny_Elam	spouse	Morgan_Paull	True
Shanna_Moakler	spouse	Travis_Barker	True
Andrés_Calamaro	spouse	Julieta_Cardinali	True
Mams_Taylor	spouse	Krista_Allen	True
Naama_Nativ_Settle	spouse	Matthew_Settle	True
Amy_Spanger	spouse	Michael_C._Hall	True
Eminem	spouse	Kimberly_Anne_Scott	True
Manuel_Schwarz	spouse	Ayumi_Hamasaki	True
Robert_Rodriguez	spouse	Rose_McGowan	True
Shogo	spouse	Eriko_Imai	True
Casey_Aldridge	spouse	Jamie_Lynn_Spears	True
Emmanuel_Xuereb	spouse	Stacey_Dash	True
Pollyanna_McIntosh	spouse	Grant_Show	True
Heidi_Klum	spouse	Seal	True
Justin_Siegel	spouse	Emmy_Rossum	True
Lina_Romay	spouse	Jesús_Franco	True
Shraddha_Nigam	spouse	Karan_Singh_Grover	True
Lora_Lee_Ecobelli	spouse	Leo_Burmester	True
Adjowa_Hayes	spouse	Isaac_Hayes	True
Heath_Ledger	spouse	Michelle_Williams	True
Patricio_Borghetti	spouse	Grettell_Valdéz	True
Susan_Lanier	spouse	Delaney_Bramlett	True
Melissa_McKnight	spouse	Matt_LeBlanc	True
Ali_Landry	spouse	Mario_López	True
Samrat_Dahal	spouse	Manisha_Koirala	True
Tamara_Brooks	spouse	Theodore_Bikel	True
Nick_Zano	spouse	Haylie_Duff	True
Jemima_Khan	spouse	Hugh_Grant	True
Aarón_Díaz	spouse	Kate_del_Castillo	True
Katie_Holmes	spouse	Tom_Cruise	True
Tori_Spelling	spouse	Charlie_Shanian	True
Jim_Carrey	spouse	Jenny_McCarthy	True
Karina_Poszar	spouse	Thom_Mathews	True
Michele_Lee	spouse	Jason_Reitman	True
Stephen_Dunham	spouse	Alexondra_Lee	True
Arun_Nayar	spouse	Elizabeth_Hurley	True
Kris_Aquino	spouse	James_Yap	True
Chelsea_Handler	spouse	Ted_Harbert	True
Ben_Indra	spouse	Anna_Faris	True
Craig_Conway	spouse	Jill_Halfpenny	True
Zöe_Salmon	spouse	Gerard_McCarthy	True
Michael_Galeotti	spouse	Bethany_Joy_Lenz-Galeotti	True
Pamela_Anderson	spouse	Kid_Rock	True
Saul_Williams	spouse	Persia_White	True
Ricky_Groves	spouse	Hannah_Waterman	True
Kim_Kardashian	spouse	Kris_Humphries	True
Eva_Green	spouse	Marton_Csokas	True
Emilia_Fox	spouse	Jared_Harris	True
Sebastian_Koch	spouse	Carice_van_Houten	True
Yashu_Ma	spouse	Nicky_Wu	True
Elsa_Pataky	spouse	Adrien_Brody	True
Marc_Anthony	spouse	Jennifer_Lopez	True
James_Belchamber	spouse	Bernard_Archard	True
Diether_Ocampo	spouse	Kristine_Hermosa	True
Nicholas_Tse	spouse	Cecilia_Cheung	True
Joseph_M._Smith	spouse	Jessica_Paré	True
Royston_Langdon	spouse	Liv_Tyler	True
Ashton_Kutcher	spouse	Demi_Moore	True
Poppy_Montgomery	spouse	Adam_Kaufman	True
Steve_McFadden	spouse	Rachel_Sidwell	True
Fahd_Mohamed_Al-Shalabi	spouse	Angham_Mohammad_Ali_Suleiman	True
Tameka_Foster	spouse	Usher	True
Christopher_Knight	spouse	Adrianne_Curry	True
Michael_Goldman	spouse	Charlotte_Ross	True
Ryan_Phillippe	spouse	Abbie_Cornish	True
Will_Arnett	spouse	Amy_Poehler	True
Alexandre_Pato	spouse	Sthefany_Brito	True
Isabella_Leong	spouse	Richard_Li	True
Foldera	foundationPlace	Huntington_Beach	True
Kana	foundationPlace	California	True
SCO_Group	foundationPlace	Santa_Cruz	True
Krstarica	foundationPlace	Belgrade	True
Apago,_Inc.	foundationPlace	Cumming	True
Interwoven	foundationPlace	Sunnyvale	True
Really_Strategies,_Inc.	foundationPlace	Lansdale	True
Silicon_Artists,_Inc.	foundationPlace	Madrid	True
Wipro_Technologies	foundationPlace	India	True
Techexcel	foundationPlace	Lafayette	True
NeXT	foundationPlace	California	True
MonsterCommerce,_LLC	foundationPlace	Belleville	True
Strategy_First	foundationPlace	Montreal	True
SAP_AG	foundationPlace	Mannheim	True
Temenos_Group	foundationPlace	Geneva	True
MailChannels	foundationPlace	Vancouver	True
KickApps	foundationPlace	New_York_City	True
Salesforce.com	foundationPlace	California	True
JetBrains	foundationPlace	Czech_Republic	True
GoldenSource	foundationPlace	New_York_City	True
SIMULIA	foundationPlace	Providence	True
QlikTech	foundationPlace	Lund	True
Cloudspace	foundationPlace	Orlando	True
Picnik	foundationPlace	Seattle	True
Nokia	foundationPlace	Nokia	True
Kineticsware,_Inc.	foundationPlace	Washington	True
Acronis	foundationPlace	United_States_of_America	True
Critical_Path,_Inc.	foundationPlace	San_Francisco	True
Microsoft	foundationPlace	Albuquerque	True
Six_Apart	foundationPlace	San_Francisco	True
Intec_Telecom_Systems	foundationPlace	Woking	True
Xero	foundationPlace	New_Zealand	True
Team_and_Concepts	foundationPlace	Hong_Kong	True
Helmi_Technologies	foundationPlace	Oulu	True
Valve_Corporation	foundationPlace	Kirkland	True
Big_Fish_Games	foundationPlace	Seattle	True
Clickability,_Inc.	foundationPlace	San_Francisco	True
IBM_Internet_Security_Systems	foundationPlace	Atlanta	True
Syntel_Inc.	foundationPlace	Troy	True
Materialise_NV	foundationPlace	Leuven	True
Nemetschek	foundationPlace	Munich	True
Hazent	foundationPlace	Alcalá_de_Henares	True
Digital_Research	foundationPlace	Pacific_Grove	True
Codemasters	foundationPlace	Warwickshire	True
MokaFive	foundationPlace	California	True
Ansoft	foundationPlace	Pittsburgh	True
Condusiv_Technologies	foundationPlace	Glendale	True
Hewlett-Packard	foundationPlace	Palo_Alto	True
IBM	foundationPlace	Endicott	True
Bloombase	foundationPlace	Shenzhen	True
Redxpress	foundationPlace	Portsmouth	True
Mindscape_Group	foundationPlace	Novato	True
Futuremark	foundationPlace	Espoo	True
Softpress	foundationPlace	Oxford	True
VYRE	foundationPlace	Iceland	True
SevOne	foundationPlace	Newark	True
Franz_Inc	foundationPlace	Berkeley	True
RightNow_Technologies	foundationPlace	Bozeman	True
Intuit_Canada	foundationPlace	Edmonton	True
Day_Software_Inc	foundationPlace	Basel	True
Blackbaud	foundationPlace	New_York_City	True
Information_Builders	foundationPlace	United_States_of_America	True
Oracle_Corporation	foundationPlace	California	True
Palm,_Inc.	foundationPlace	United_States_of_America	True
Serena_Software	foundationPlace	California	True
Attachmate	foundationPlace	Bellevue	True
Delrina	foundationPlace	Toronto	True
Lyris	foundationPlace	Berkeley	True
Navigon	foundationPlace	Hamburg	True
Pandemic_Studios	foundationPlace	Santa_Monica	True
impetus_Technologies	foundationPlace	India	True
Financial_Navigator	foundationPlace	Mountain_View	True
Audiokinetic	foundationPlace	Montreal	True
Mindquarry	foundationPlace	Potsdam	True
Spokeo	foundationPlace	Mountain_View	True
Venus_Williams	birthPlace	Lynwood,_California	True
Dr._Dre	birthPlace	Compton,_California	True
Cher	birthPlace	El_Centro,_California	True
David_Lloyd_George	birthPlace	Manchester	True
Abraham_Lincoln	birthPlace	Hodgenville,_Kentucky	True
Yoko_Ono	birthPlace	Tokyo	True
William_Howard_Taft	birthPlace	Cincinnati	True
Woodrow_Wilson	birthPlace	Staunton,_Virginia	True
Mardy_Fish	birthPlace	Edina,_Minnesota	True
Robert_Christgau	birthPlace	New_York_City	True
Victoria_Azarenka	birthPlace	Minsk	True
Charles_Dickens	birthPlace	Portsmouth	True
Ozzy_Osbourne	birthPlace	Birmingham	True
Nelly_Furtado	birthPlace	Victoria,_British_Columbia	True
George_W._Bush	birthPlace	New_Haven,_Connecticut	True
Emmylou_Harris	birthPlace	Birmingham,_Alabama	True
Billy_Joel	birthPlace	New_York_City	True
Pierre_Trudeau	birthPlace	Montreal	True
Justin_Timberlake	birthPlace	Memphis,_Tennessee	True
Kamal_Haasan	birthPlace	Paramakudi	True
Stevie_Wonder	birthPlace	Saginaw,_Michigan	True
Lou_Reed	birthPlace	Brooklyn	True
Robert_De_Niro	birthPlace	New_York_City	True
Muhammad_Ali	birthPlace	Louisville,_Kentucky	True
Nenad_Zimonjić	birthPlace	Belgrade	True
Frank_Lloyd_Wright	birthPlace	Richland_Center,_Wisconsin	True
Jay-Z	birthPlace	New_York_City	True
John_Lennon	birthPlace	Liverpool	True
Usher_(entertainer)	birthPlace	Dallas	True
Michael_Chang	birthPlace	Hoboken,_New_Jersey	True
Arthur_Wellesley,_1st_Duke_of_Wellington	birthPlace	Dublin	True
Jimi_Hendrix	birthPlace	Seattle	True
James_Brown	birthPlace	Barnwell,_South_Carolina	True
Johnny_Mercer	birthPlace	Savannah,_Georgia	True
Björk	birthPlace	Reykjavík	True
Bob_Dylan	birthPlace	Duluth,_Minnesota	True
Andy_Roddick	birthPlace	Omaha,_Nebraska	True
Olivia_Newton-John	birthPlace	Cambridge	True
Clint_Eastwood	birthPlace	San_Francisco	True
Jana_Novotná	birthPlace	Brno	True
Brian_Wilson	birthPlace	Inglewood,_California	True
Noam_Chomsky	birthPlace	Philadelphia	True
H._P._Lovecraft	birthPlace	Providence,_Rhode_Island	True
Mary_J._Blige	birthPlace	The_Bronx	True
Jimmy_Carter	birthPlace	Plains,_Georgia	True
Cole_Porter	birthPlace	Peru,_Indiana	True
Chiang_Kai-shek	birthPlace	Fenghua	True
Bruce_Springsteen	birthPlace	Long_Branch,_New_Jersey	True
Frank_Zappa	birthPlace	Baltimore	True
Kylie_Minogue	birthPlace	Melbourne	True
David_Nalbandian	birthPlace	Unquillo	True
Kofi_Annan	birthPlace	Kumasi	True
William_McKinley	birthPlace	Niles,_Ohio	True
Avril_Lavigne	birthPlace	Belleville,_Ontario	True
Mammootty	birthPlace	Chempu	True
Bing_Crosby	birthPlace	Tacoma,_Washington	True
Mark_Woodforde	birthPlace	Adelaide	True
Stephen_Harper	birthPlace	Toronto	True
Cara_Black	birthPlace	Harare	True
Ray_Charles	birthPlace	Albany,_Georgia	True
Stephen_King	birthPlace	Portland,_Maine	True
Arthur_Conan_Doyle	birthPlace	Edinburgh	True
Martina_Navratilova	birthPlace	Prague	True
Robbie_Williams	birthPlace	Stoke-on-Trent	True
George_Bernard_Shaw	birthPlace	Dublin	True
Neil_Young	birthPlace	Toronto	True
Janet_Jackson	birthPlace	Gary,_Indiana	True
Beck	birthPlace	Los_Angeles	True
Martin_Scorsese	birthPlace	Queens	True
John,_King_of_England	birthPlace	Oxford	True
Woody_Allen	birthPlace	The_Bronx	True
Tony_Blair	birthPlace	Edinburgh	True
Dick_Cheney	birthPlace	Lincoln,_Nebraska	True
Jelena_Janković	birthPlace	Belgrade	True
Donna_Summer	birthPlace	Boston	True
Woodrow_Wilson	deathPlace	Minneapolis	False
William_McKinley	deathPlace	Long_Branch,_New_Jersey	False
Gottfried_Wilhelm_Leibniz	subsidiary	The_Bronx	False
Stanley_Kubrick	subsidiary	Kumasi	False
George_W._Bush	author	Memphis,_Tennessee	False
Christina_Aguilera	team	Dublin	False
Walter_Scott	starring	New_York_City	False
Gary_Cooper	subsidiary	Dallas	False
Mardy_Fish	office	Norfolk,_Virginia	False
Philip_K._Dick	subsidiary	The_Bronx	False
Dolly_Parton	spouse	New_York_City	False
Calvin_Coolidge	team	Santa_Monica,_California	False
Cher	birthPlace	The_Bronx	False
Kurt_Vonnegut	subsidiary	Dublin	False
Bryan_Adams	foundationPlace	Concord,_New_Hampshire	False
John_Ford	award	Los_Angeles	False
Paul_Simon	team	Colombo	False
Paul_Haarhuis	deathPlace	Staunton,_Virginia	False
Ozzy_Osbourne	spouse	Beverly_Hills,_California	False
John_Wayne	author	Caracas	False
John_Lee_Hooker	award	West_Hollywood,_California	False
Cole_Porter	deathPlace	Kiel	False
Mohammad_Reza_Pahlavi	birthPlace	New_York_City	False
Janet_Jackson	birthPlace	Belgrade	False
Tennessee_Williams	office	Portland,_Maine	False
Ira_Gershwin	spouse	Boston	False
David_Nalbandian	deathPlace	Los_Angeles	False
Yoko_Ono	office	Beverly_Hills,_California	False
Herbert_Hoover	starring	Los_Angeles	False
Charlie_Parker	subsidiary	Melbourne	False
Arthur_Ashe	birthPlace	Lynwood,_California	False
Akira_Kurosawa	award	Camarillo,_California	False
Daniel_Nestor	award	Eindhoven	False
Shakira	team	Los_Angeles	False
Martina_Navratilova	deathPlace	Hollywood,_Florida	False
Tom_Hanks	team	Dublin	False
Shaquille_O'Neal	foundationPlace	San_Francisco	False
Bryan_Adams	deathPlace	Branson,_Missouri	False
Oscar_Peterson	spouse	West_Hollywood,_California	False
William_Howard_Taft	team	Belgrade	False
Charlie_Parker	deathPlace	Los_Angeles	False
Donna_Summer	foundationPlace	Lynwood,_California	False
Jonathan_Swift	team	Staunton,_Virginia	False
Philip_K._Dick	birthPlace	Fort_Lauderdale,_Florida	False
John_Adams	birthPlace	Fort_Worth,_Texas	False
Edward_Drinker_Cope	spouse	Victoria,_British_Columbia	False
Donna_Summer	author	Königsberg	False
Tony_Blair	spouse	Edinburgh	False
Fred_Astaire	author	Adelaide	False
Mohammad_Reza_Pahlavi	starring	Tunis	False
Stanley_Kubrick	office	Queens	False
Kurt_Aland	author	Hoboken,_New_Jersey	False
Samantha_Stosur	office	Akron,_Ohio	False
Walter_Scott	award	Oxford	False
Hank_Williams	award	Ottawa	False
William_Howard_Taft	award	Ottawa	False
Michael_Jordan	author	Belgrade	False
Jacqueline_Kennedy_Onassis	office	Cincinnati	False
Elizabeth_Taylor	deathPlace	Cairo	False
James_Brown	deathPlace	Los_Angeles	False
Herman_Melville	birthPlace	Barranquilla	False
Éamon_de_Valera	foundationPlace	Dallas	False
Benjamin_Franklin	starring	Kingston,_Ontario	False
Rutherford_B._Hayes	starring	Oxford	False
William_III_of_England	birthPlace	Unquillo	False
Charles_Dickens	foundationPlace	Belgrade	False
Robbie_Williams	office	Los_Angeles	False
Ted_Kennedy	team	Oxford	False
Mike_Bryan	foundationPlace	Beverly_Hills,_California	False
Jefferson_Davis	office	Kiel	False
Billy_Preston	subsidiary	Setagaya,_Tokyo	False
John_Lennon	birthPlace	Nashville,_Tennessee	False
Hank_Williams	office	Brooklyn	False
Rudyard_Kipling	author	Santa_Barbara,_California	False
George_Balanchine	subsidiary	Prague	False
Gabriel_Aubry	office	Nobel_Prize_in_Literature	False
Hal_Roach	birthPlace	Lynwood,_California	False
IBM_Internet_Security_Systems	author	Czech_Republic	False
Warren_G._Harding	foundationPlace	Waverly,_Minnesota	False
Gabriel_Aubry	award	Melbourne	False
Lil'_John_Roberts	award	Plains,_Georgia	False
Brian_Wilson	author	Liverpool	False
Charles_Mingus	award	Fremont,_Ohio	False
Heath_Ledger	starring	Santa_Barbara,_California	False
Hyperion_Entertainment	foundationPlace	Palm_Desert,_California	False
John_William_Strutt	foundationPlace	Michelle_Williams	False
Rudyard_Kipling	team	Springfield,_Missouri	False
Stevie_Wonder	office	Nobel_Prize_in_Physics	False
Blackbaud	team	Cecilia_Cheung	False
Isabella_Leong	author	Vancouver	False
Prince_(musician)	deathPlace	Englewood,_New_Jersey	False
Lou_Reed	subsidiary	Los_Angeles	False
Edgar_Allan_Poe	subsidiary	Beverly_Hills,_California	False
Dialogic_Corporation	deathPlace	Eriko_Imai	False
Materialise_NV	starring	Kerr_Smith	False
KickApps	award	Providence,_Rhode_Island	False
Ness_Wadia	foundationPlace	Nobel_Prize_in_Physics	False
OpenLink_Software	spouse	Salt_Lake_City	False
John_Lennon	author	California	False
Dolly_Parton	starring	Potsdam	False
Applied_Minds	spouse	Beverly_Hills,_California	False
Mardy_Fish	award	San_Francisco	False
Beck	birthPlace	Alexondra_Lee	False
Uprizer_Labs_LLC	subsidiary	San_Francisco	False
Novak_Djokovic	office	Dallas	False
Angoss	office	The_Bronx	False
Tennessee_Williams	team	Lamar,_Missouri	False
Marc_Anthony	team	Nobel_Prize_in_Literature	False
Walther_Bothe	birthPlace	Nobel_Prize_in_Literature	False
Chris_Evert	author	Alki_David	False
Yashu_Ma	foundationPlace	Madison	False
Lil'_John_Roberts	office	Melbourne	False
Nils_Gustaf_Dalén	deathPlace	Nobel_Prize_in_Literature	False
Isabella_Leong	spouse	Englewood,_New_Jersey	False
Lou_Reed	deathPlace	Chandler,_Arizona	False
Xero	award	Manisha_Koirala	False
Lora_Lee_Ecobelli	deathPlace	Sthefany_Brito	False
Ryan_Phillippe	starring	Nobel_Prize_in_Literature	False
Frédéric_Passy	foundationPlace	Matthew_Settle	False
International_Atomic_Energy_Agency	starring	Newport_News,_Virginia	False
Jim_Henson	spouse	Seattle	False
Max_Planck	office	Nobel_Prize_in_Literature	False
Otis_Redding	deathPlace	Norway	False
Chris_Coghill	deathPlace	Bochum	False
George_Carlin	foundationPlace	Billy_Rovzar	False
Michael_Jordan	starring	Boston	False
LeBron_James	birthPlace	Potsdam	False
IBM	foundationPlace	Provo	False
CoCreate	subsidiary	Palo_Alto	False
Ai_Sugiyama	award	Bryan	False
William_McKinley	foundationPlace	Thom_Mathews	False
Immanuel_Kant	award	Nuremberg	False
Halldór_Laxness	author	Unquillo	False
Conway_Twitty	spouse	Barnwell,_South_Carolina	False
Ira_Gershwin	subsidiary	Mario_López	False
George_Jones	deathPlace	Daniel_Craig	False
Grameen_Bank	birthPlace	Emmy_Rossum	False
Audiokinetic	foundationPlace	Richard_Li	False
Emmylou_Harris	starring	Tunis	False
SNP_Schneider-Neureither_&_Partner_AG	author	Gaile_Lok	False
Muhammad_Ali	office	Nobel_Prize_in_Literature	False
Henryk_Sienkiewicz	award	Fenghua	False
Saul_Williams	award	Nobel_Prize_in_Literature	False
Grihalakshmi	starring	Albany,_Georgia	False
XITEX_Software	subsidiary	Ayumi_Hamasaki	False
Michael_Chang	office	Nobel_Prize_in_Literature	False
Roy_Orbison	spouse	Nobel_Prize_in_Literature	False
Eugenio_Montale	subsidiary	Sevierville,_Tennessee	False
Wipro_Technologies	foundationPlace	Anna_Faris	False
Team_and_Concepts	award	Kumasi	False
Mike_Miller_(basketball_player)	subsidiary	Novato	False
Anwar_Sadat	foundationPlace	Nobel_Prize_in_Literature	False
Felipe_González	team	The_Postman	False
Ionatana_Ionatana	subsidiary	Fiji	False
C._S._Lewis	office	Portugal	False
AOL	award	Nobel_Prize_in_Literature	False
Sun_Microsystems	deathPlace	Bob_Guiney	False
Deryck_Whibley	starring	Nobel_Prize_in_Literature	False
Zach_Randolph	deathPlace	Boston_Celtics	False
NBCUniversal	spouse	Minneapolis	False
Clickability,_Inc.	spouse	Brisbane	False
Uprizer_Labs_LLC	spouse	Kirkland	False
Joseph_Brodsky	spouse	Nobel_Prize_in_Physics	False
Ernest_Hemingway	spouse	Roderick	False
Katie_Holmes	office	Chicago	False
Gerald_W._Page	office	Spain	False
Materialise_NV	team	New_York_City	False
Kurt_Vonnegut	foundationPlace	ProQuent_Systems	False
Alan_E._Nourse	birthPlace	Ted_Harbert	False
Wipro_Technologies	award	Lansdale	False
Gerald_Ford	deathPlace	New_York_City	False
Kanye_West	spouse	Norway	False
Gamal_Abdel_Nasser	deathPlace	Canada	False
William_Butler_Yeats	starring	Nobel_Prize_in_Chemistry	False
Sebastian_Koch	birthPlace	Los_Altos,_California	False
Jean-Pierre_Raffarin	office	San_Antonio_Spurs	False
Chris_Benoit	team	John_Enos_III	False
Jean-Pierre_Raffarin	award	Manchester	False
Dwight_Howard	starring	Clarity_Wireless,_Inc	False
Philip_K._Dick	office	1635:_The_Cannon_Law	False
Apple_Inc.	subsidiary	Melbourne	False
Yevgeny_Zamyatin	office	Avogadro	False
George_Zebrowski	author	France	False
Infor	deathPlace	Finland	False
Elton_Brand	subsidiary	Nobel_Peace_Prize	False
Salvatore_Quasimodo	office	Tivoli_Systems,_Inc.	False
Michael_F._Flynn	team	Nobel_Prize_in_Physics	False
SRI_International	author	Nobel_Prize_in_Physics	False
iUpload	spouse	Detroit_Pistons	False
K._W._Jeter	spouse	Portal_Software	False
Winston_Churchill	office	Paul_McGann	False
Keizō_Obuchi	team	Jamie_Yeo	False
Charlie_Sheen	author	Norway	False
Gene_Brewer	deathPlace	Novato	False
NetQoS	award	Springbank	False
Emma_McAllister	deathPlace	Worldwar:_Upsetting_the_Balance	False
Serena_Williams	spouse	Los_Angeles_Clippers	False
Motorola	deathPlace	iVillage	False
Max_von_Laue	deathPlace	Springfield,_Missouri	False
Amy_Spanger	author	Hugh_Grant	False
Synopsys	birthPlace	The_Poison_Belt	False
Kwame_Brown	office	Michael_C._Hall	False
Mammootty	author	Daniel_Craig	False
Apple_Inc.	deathPlace	Nobel_Prize_in_Literature	False
Brian_McFadden	birthPlace	Fiji	False
Chris_Coghill	subsidiary	Concord,_California	False
Mardy_Fish	author	The_Hitchhiker's_Guide_to_the_Galaxy	False
James_Brown	birthPlace	CommQuest	False
Oracle_Corporation	award	Los_Angeles_Lakers	False
Albert_Camus	spouse	United_Kingdom	False
Julius_Axelrod	starring	Anna_Nicole_Smith	False
Alexis_Valdés	subsidiary	Abbie_Cornish	False
Kate_Wilhelm	birthPlace	Baghdad	False
Kishore_Kumar	foundationPlace	Nobel_Prize_in_Literature	False
Guglielmo_Marconi	starring	Kerr_Smith	False
NBCUniversal	office	The_Poison_Belt	False
George_Balanchine	starring	Los_Angeles_Clippers	False
Mindscape_Group	deathPlace	Nashville,_Tennessee	False
Arthur_Conan_Doyle	office	Dayton,_Tennessee	False
Akbar	foundationPlace	Oxford	False
Cisco_Systems,_Inc.	foundationPlace	Queens	False
IWin.com	subsidiary	Canada	False
Thomas_M._Disch	deathPlace	Rachel_Sidwell	False
Jean_Bonnefoy	starring	Djibouti	False
XITEX_Software	spouse	Gary,_Indiana	False
Arthur_Conan_Doyle	starring	Venus_on_the_Half-Shell	False
Techexcel	deathPlace	Chempu	False
Michael_Jordan	foundationPlace	Chennai	False
Derek_Fisher	birthPlace	Dallas_Mavericks	False
Dries_van_Agt	author	Kid_Rock	False
Hubert_Humphrey	author	Dayton,_Tennessee	False
Michael_Goldman	award	Belgrade	False
Mary_Pickford	team	Persia_White	False
Rasheed_Wallace	deathPlace	Prague	False
Franklin_Pierce	foundationPlace	Nobel_Peace_Prize	False
Maria_das_Neves	deathPlace	Egypt	False
Dell	team	Montreal	False
Gerhart_Hauptmann	author	The_World_Is_Round	False
Chris_Benoit	birthPlace	Melbourne	False
Arthur_Conan_Doyle	starring	Berkeley	False
Ahmed_Ouyahia	author	Lansdale	False
Ibrahim_al-Jaafari	spouse	Dominion_of_Newfoundland	False
Daniel_Nestor	starring	Glendale	False
Stephen_Hensley	birthPlace	Hollywood,_Florida	False
Lina_Romay	team	Nobel_Prize_in_Literature	False
Steve_Blake	starring	Los_Angeles	False
Rasheed_Wallace	foundationPlace	Chicago	False
Nazr_Mohammed	deathPlace	Nobel_Prize_in_Literature	False
Arthur_Wellesley,_1st_Duke_of_Wellington	birthPlace	Münster	False
Raymond_Poincaré	subsidiary	Billy_Rovzar	False
Isaac_Hayes	author	Fort_Worth,_Texas	False
Walter_Scott	author	Carrie	False
Terry_Pratchett	foundationPlace	Portland_Trail_Blazers	False
Manuel_Azaña	foundationPlace	The_Garden_of_Rama	False
Marc_Anthony	birthPlace	Münster	False
Delrina	team	334	False
Jason_Richardson	team	Norway	False
Laurent_Fabius	spouse	New_Haven,_Connecticut	False
Robert_Rodriguez	deathPlace	Edinburgh	False
Rasheed_Wallace	office	Finland	False
Gottfried_Wilhelm_Leibniz	spouse	Lamar,_Missouri	False
Camilo_José_Cela	starring	Canada	False
Mike_Bryan	award	Detroit_Pistons	False
Glenn_Ong	award	Nobel_Prize_in_Physics	False
Lyris	office	Anna_Faris	False
Nazr_Mohammed	starring	John_Enos_III	False
Marc_Anthony	subsidiary	Dallas_Mavericks	False
Emeka_Okafor	author	Alicante	False
Stephen_Baxter	office	Charlotte_Bobcats	False
Robert_Silverberg	deathPlace	Los_Angeles	False
Sarah_Vaughan	deathPlace	Jill_Scott	False
Thelonious_Monk	subsidiary	Davenport,_Iowa	False
Modus_Operandi_Incorporated	office	The_Outward_Urge	False
Saul_Williams	team	Bellevue	False
William_Howard_Taft	foundationPlace	Waverly,_Minnesota	False
Tim_Henman	subsidiary	Los_Angeles_Clippers	False
Ricky_Groves	birthPlace	James_Franco	False
Eva_Green	birthPlace	New_Haven,_Connecticut	False
Brian_McFadden	foundationPlace	Tokyo	False
Ionatana_Ionatana	birthPlace	Marton_Csokas	False
Michael_Galeotti	starring	Minnesota_Timberwolves	False
Harry_S._Truman	subsidiary	I_Will_Fear_No_Evil	False
Saul_Williams	author	Nobel_Prize_in_Literature	False
Joop_den_Uyl	deathPlace	Nova_Express	False
Critical_Software	subsidiary	Santa_Monica	False
Chris_Bosh	birthPlace	Summon_the_Thunder	False
Lleyton_Hewitt	birthPlace	Geneva	False
Mindscape_Group	author	Indiana_Pacers	False
Timbaland	subsidiary	Iraq	False
Gottfried_Wilhelm_Leibniz	award	Nobel_Prize_in_Physics	False
Ursula_K._Le_Guin	starring	Battlefield_Earth	False
Mikhail_Kasyanov	deathPlace	Boston_Celtics	False
Gerald_Wallace	birthPlace	Non-Stop	False
Winston_Churchill	foundationPlace	Memphis_Grizzlies	False
Angela_Carter	award	Jack_Faust	False
Dean_Martin	award	Texas	False
Dan_Simmons	team	New_York_City	False
Jefferson_Davis	starring	Beverly_Hills,_California	False
Christina_Aguilera	spouse	Staunton,_Virginia	False
Dayton_Ward	starring	Boston_Celtics	False
Backbone_Entertainment	birthPlace	Houston_Rockets	False
Novak_Djokovic	deathPlace	Dublin	False
Jamal_Crawford	foundationPlace	New_York_City	False
Robert_Menzies	subsidiary	Boston_Celtics	False
Johnny_Mercer	birthPlace	Carrie	False
Robert_A._Heinlein	team	Albuquerque	False
Giosuè_Carducci	subsidiary	Troy	False
Chelsea_Handler	starring	Jesús_Franco	False
John_Steinbeck	deathPlace	Alcalá_de_Henares	False
Charles_Édouard_Guillaume	deathPlace	Way_Station	False
Wipro_Technologies	birthPlace	Nobel_Prize_in_Literature	False
Derek_Fisher	subsidiary	Hannah_Waterman	False
Jason_Richardson	deathPlace	Seal	False
Michael_Jackson	spouse	Rose_McGowan	False
Intec_Telecom_Systems	starring	Phoenix_Suns	False
Mary_J._Blige	starring	Kingsland,_Arkansas	False
Derek_Fisher	foundationPlace	Ketchum,_Idaho	False
IntelliCorp	birthPlace	Memphis,_Tennessee	False
Herman_Melville	team	Immodest_Proposals	False
Ira_Levin	subsidiary	Adrianne_Curry	False
Donna_Summer	subsidiary	Charlottesville,_Virginia	False
Information_Builders	subsidiary	Philadelphia_76ers	False
Stephanie_Gibson	office	England	False
Simone_Sestito	foundationPlace	The_Caves_of_Steel	False
Richard_Rodgers	office	Scottsdale,_Arizona	False
Howard_Hughes	foundationPlace	Melbourne	False
Stevie_Wonder	award	Cincinnati	False
Pervasive_Software	award	Bochum	False
Saint-John_Perse	birthPlace	The_Forever_War	False
William_Ewart_Gladstone	office	Nas	False
Dwight_Howard	deathPlace	Nobel_Prize_in_Literature	False
Frank_Zappa	deathPlace	Ottawa	False
Ozzy_Osbourne	starring	New_York_City	False
Mams_Taylor	award	Santa_Monica,_California	False
Carmelo_Anthony	office	Worldwar:_Upsetting_the_Balance	False
Woody_Guthrie	foundationPlace	Makati	False
Brian_McFadden	spouse	Ottawa	False
Todd_Woodbridge	award	Nobel_Prize_in_Literature	False
Ivan_Ljubičić	team	Brooklyn	False
Lucille_Ball	subsidiary	Charlotte_Bobcats	False
Melissa_McKnight	deathPlace	Cleveland_Cavaliers	False
Vernor_Vinge	foundationPlace	1634:_The_Ram_Rebellion	False
Philip_José_Farmer	deathPlace	Glendale	False
A._E._van_Vogt	office	Polyphemus	False
Jaroslav_Seifert	award	Rancho_Mirage,_California	False
Rasheed_Wallace	office	The_Gods_of_Mars	False
Kevin_Garnett	author	Agra	False
William_Butler_Yeats	office	Cleveland_Cavaliers	False
Octavio_Paz	spouse	California	False
Autodesk	birthPlace	Solange_Knowles	False
J._R._Smith	foundationPlace	Nobel_Prize_in_Literature	False
Arun_Nayar	deathPlace	Krista_Allen	False
Andris_Biedriņš	deathPlace	Belgrade	False
John_Lee_Hooker	subsidiary	Dave_Morgan	False
Pierre_Trudeau	author	Adam_Kaufman	False
Miguel_Ángel_Asturias	birthPlace	Nobel_Prize_in_Literature	False
Romain_Rolland	author	Daniel_Craig	False
Chauncey_Billups	spouse	Return_from_the_Stars	False
E._E._Smith	author	Nobel_Prize_in_Literature	False
Nancy_Kress	foundationPlace	Golden_State_Warriors	False
Chris_Kaman	starring	Billy_Rovzar	False
Ira_Gershwin	office	Omaha,_Nebraska	False
Tyson_Chandler	office	Riddley_Walker	False
Ivan_Ljubičić	birthPlace	Phoenix_Suns	False
Spiceworks	office	Mena_Suvari	False
John_Lee_Hooker	subsidiary	The_Hague	False
Thomas_Mann	office	Los_Angeles	False
Jimi_Hendrix	foundationPlace	Delaney_Bramlett	False
David_W._Donoho	deathPlace	Minsk	False
Redxpress	subsidiary	Peru,_Indiana	False
Benjamin_Franklin	author	Jared_Harris	False
Ryan_Phillippe	deathPlace	San_Francisco	False
Susannah_Harker	birthPlace	Back_in_the_USSA	False
Stephen_Dunham	award	Los_Angeles_Lakers	False
Sonia_Agarwal	deathPlace	Fort_Worth,_Texas	False
Orhan_Pamuk	subsidiary	Leo_Burmester	False
crism_consulting	birthPlace	New_York_City	False
FrontRange_Solutions	deathPlace	Nobel_Prize_in_Literature	False
Paul_McCartney	award	Nobel_Prize_in_Physics	False
Jude_Law	subsidiary	Motihari	False
Shanna_Moakler	award	Kirkland	False
Aleksandr_Solzhenitsyn	starring	Rose_McGowan	False
Pierre_Trudeau	starring	Morgan_Paull	False
Navigon	foundationPlace	Cumming	False
Richard_Rodgers	author	The_Road_to_Mars	False
Isaac_Asimov	author	Travis_Barker	False
Johnny_Mercer	award	Portsmouth	False
Stephen_King	subsidiary	Berkeley	False
Jerry_Pournelle	deathPlace	Hamburg	False
Benjamin_Harrison	author	Espoo	False
Robert_Mitchum	deathPlace	Nobel_Prize_in_Literature	False
William_S._Burroughs	team	Again,_Dangerous_Visions	False
Iain_Banks	office	Lincoln,_Nebraska	False
François_Mauriac	award	Austin	False
Gao_Xingjian	birthPlace	Nobel_Prize_in_Literature	False
Ivo_Andrić	award	Basel	False
Team_and_Concepts	birthPlace	Mississauga	False
Justin_Siegel	team	Nobel_Prize_in_Physics	False
Harold_Lloyd	starring	Peru,_Indiana	False
Jonathan_Swift	spouse	John_Enos_III	False
Ian_Stewart	birthPlace	Nobel_Prize_in_Physics	False
Chris_Benoit	author	Nobel_Prize_in_Physics	False
Hal_Roach	deathPlace	Montreal	False
Shirin_Ebadi	birthPlace	Marco_Khan	False
Shraddha_Nigam	spouse	Vancouver	False
Zulfikar_Ali_Bhutto	spouse	Belgrade	False
William_Gibson	spouse	Toronto	False
Blogging_Systems_Group	starring	Isaac_Hayes	False
Jay-Z	spouse	Helsinki	False
Mel_Tormé	office	Vril	False
MokaFive	birthPlace	Los_Altos,_California	False
David_Gerrold	birthPlace	Waverly,_Minnesota	False
NetQoS	starring	Nobel_Prize_in_Physics	False
LogiSense	team	Mississauga	False
Lou_Reed	deathPlace	Omaha,_Nebraska	False
Delrina	award	Nobel_Prize_in_Literature	False
Sarah_Vaughan	office	Out_of_the_Silent_Planet	False
David_Brin	foundationPlace	James_Yap	False
Stephen_Dunham	birthPlace	Nobel_Prize_in_Literature	False
Theodor_Mommsen	subsidiary	Nobel_Prize_in_Literature	False
Chelsea_Handler	deathPlace	Olga_Kurylenko	False
Donna_Summer	deathPlace	Nobel_Prize_in_Literature	False
Henry_Dunant	starring	Montreal	False
Oscar_Wilde	award	Vril	False
Rodman_Philbrick	subsidiary	Kansas_City,_Missouri	False
Stephen_Dunham	office	Dublin	False
Max_Mirnyi	award	Portsmouth	False
Kylie_Minogue	starring	St_Albans	False
Willie_Nelson	team	The_Continent_Makers_and_Other_Tales_of_the_Viagens	False
Dan_Brown	subsidiary	New_York_City	False
Mary_Doria_Russell	birthPlace	Riddley_Walker	False
Hubert_Humphrey	deathPlace	Takashi_Kashiwabara	False
Jesse_James	birthPlace	Nobel_Prize_in_Literature	False
Bing_Crosby	award	Belgrade	False
George_Balanchine	spouse	Motihari	False
Melanie_Leis	team	Charlottesville,_Virginia	False
Otis_Redding	author	Münster	False
Ahmed_Zewail	foundationPlace	Lynwood,_California	False
Barry_B._Longyear	birthPlace	Level_7	False
MarkLogic	team	Norway	False
Shogo	spouse	Santa_Monica	False
Ai_Sugiyama	award	Belgium	False
Ben_Indra	spouse	Synthesis_&_Other_Virtual_Realities	False
Tupac_Shakur	birthPlace	Footprints_on_Sand	False
Luther_Davis	author	Nobel_Prize_in_Literature	False
Gerald_Ford	award	Boston	False
Robert_Charles_Wilson	spouse	A_Door_into_Ocean	False
Beck	foundationPlace	Heidelberg	False
Kishore_Kumar	starring	Ljubljana	False
Satsuki_Mitchell	office	Nobel_Prize_in_Literature	False
Bjørnstjerne_Bjørnson	deathPlace	Nobel_Prize_in_Physics	False
Edward_Scissorhands	birthPlace	New_Haven,_Connecticut	False
James_Stewart	team	Nashville,_Tennessee	False
Emma_McAllister	starring	Estonia	False
Rabindranath_Tagore	birthPlace	Nobel_Prize_in_Literature	False
Kathy_Tyers	office	Russell_Brand	False
Nelly_Sachs	subsidiary	Belleville,_Ontario	False
Softpress	birthPlace	Portsmouth	False
Arun_Nayar	subsidiary	Conrail	False
Channing_Frye	author	Canada	False
Kanye_West	award	Seattle	False
Jamal_Crawford	team	Karan_Singh_Grover	False
John_Brunner	deathPlace	Jeff_Goldblum	False
Awem	award	New_York_City	False
Autodesk	author	Where_Late_the_Sweet_Birds_Sang	False
Ahna_O'Reilly	spouse	Chicago_Bulls	False
Ben_Gordon	office	Nobel_Prize_in_Physics	False
Shaun_Livingston	subsidiary	Ottawa	False
Ronald_Cheng	spouse	Yugoslavia	False
Jennie_Lee	starring	New_Orleans_Hornets	False
George_Balanchine	subsidiary	Voyages_by_Starlight	False
John_Coltrane	starring	Utah_Jazz	False
ByteMobile	team	Laird_Macintosh	False
Henry_Dunant	deathPlace	Brad_Pitt	False
Shmuel_Yosef_Agnon	author	Nobel_Prize_in_Physics	False
Dan_Brown	author	India	False
Hewlett-Packard	spouse	Barbara_Hershey	False
Adobe_Systems	team	Grettell_Valdéz	False
Walther_Bothe	team	Macrolife	False
Gabriel_Aubry	subsidiary	Jonah_Hill	False
Day_Software_Inc	spouse	Uma_Thurman	False
Ronald_Cheng	foundationPlace	Nobel_Prize_in_Physics	False
Codemasters	author	Prashanth	False
CoCreate	foundationPlace	New_York,_New_Haven_and_Hartford_Railroad	False
Kelly_Clarkson	foundationPlace	Sthefany_Brito	False
Robert_A._Heinlein	award	Los_Angeles_Lakers	False
Borland	birthPlace	The_Integral_Trees	False
Dom_Mintoff	starring	Ljubljana	False
Shraddha_Nigam	award	Rawalpindi	False
The_Walt_Disney_Company	foundationPlace	Albuquerque	False
Ahna_O'Reilly	birthPlace	California	False
AOL	starring	Branson,_Missouri	False
Laurent_Fabius	author	Nobel_Prize_in_Literature	False
Miles_Davis	spouse	Houston_Rockets	False
Mean_Girls	spouse	Belgium	False
Ed_Wood_(film)	starring	Hugh_Keays-Byrne	False
Ronald_Cheng	award	Veronica_Cartwright	False
Camilo_José_Cela	office	Quigo	False
John_Lucas_III	author	Charlotte_Bobcats	False
Heather_Khan	subsidiary	Toronto_Raptors	False
José_Echegaray	foundationPlace	Quincy,_Massachusetts	False
Charles_Stross	subsidiary	Kawasaki	False
Infor	office	New_York_City	False
Ray_Charles	subsidiary	Matt_LeBlanc	False
China_Miéville	author	Ashlee_Simpson-Wentz	False
IBM	award	Los_Angeles_Clippers	False
Stanisław_Lem	starring	Slaughterhouse-Five	False
Arun_Nayar	spouse	Iraq	False
Jack_Dann	office	Basel	False
Conway_Twitty	foundationPlace	Connetics	False
Poul_Anderson	foundationPlace	Eva_Longoria	False
Cecil_Rhodes	author	Hyperion_Solutions	False
Om_Shanti_Om	subsidiary	Miami_Heat	False
Judy_Garland	deathPlace	Belgium	False
Jason_Terry	subsidiary	Nashville,_Tennessee	False
Kevin_Garnett	foundationPlace	Amanda_Seyfried	False
Steve_Blake	foundationPlace	Christel_Khalil	False
Mean_Girls	birthPlace	Dublin	False
Frank_Sinatra	award	Seattle	False
Camp_Rock	deathPlace	Persia_White	False
William_McKinley	subsidiary	Mary-Louise_Parker	False
Kaysone_Phomvihane	subsidiary	Minnesota_Timberwolves	False
John,_King_of_England	starring	Fifty_Degrees_Below	False
Wilhelm_Wien	author	The-Dream	False
Manhattan_Associates	spouse	Queens	False
Elizabeth_Taylor	office	Minsk	False
Amy_Spanger	deathPlace	Selvaraghavan	False
Anthony_Quinn	starring	John_Enos_III	False
Dizzy_Gillespie	team	Boston	False
Heather_Khan	award	Philadelphia	False
Kobe_Bryant	spouse	Dublin	False
Jeffrey_Dean_Morgan	team	Carice_van_Houten	False
Elizabeth_Taylor	starring	Beverly_Hills,_California	False
Samrat_Dahal	birthPlace	Liverpool	False
Manuel_Schwarz	deathPlace	Solange_Knowles	False
Woody_Allen	deathPlace	Liv_Tyler	False
Mike_Bryan	spouse	Hamlet,_North_Carolina	False
Avril_Lavigne	deathPlace	Toronto	False
Jude_Law	subsidiary	Adelaide	False
Stephen_Dunham	author	Santa_Barbara,_California	False
John_Adams	author	Duluth,_Minnesota	False
Frank_Lloyd_Wright	office	Melbourne	False
Lindsay_Zir	birthPlace	Kate_del_Castillo	False
Martin_Scorsese	subsidiary	Adam_Kaufman	False
Michael_Jackson	deathPlace	Kristine_Hermosa	False
Zöe_Salmon	deathPlace	Philadelphia	False
Mohammad_Reza_Pahlavi	subsidiary	New_York_City	False
Harry_S._Truman	author	Sthefany_Brito	False
Hiroko_Hatano	subsidiary	Portland,_Maine	False
Jessie_Wallace	foundationPlace	New_York_City	False
David_Ferrer	award	Birmingham	False
Ryan_Phillippe	birthPlace	Ottawa	False
Shaquille_O'Neal	foundationPlace	Belgrade	False
Jude_Law	author	Warm_Springs,_Georgia	False
Frank_Sinatra	deathPlace	Los_Angeles	False
James_Brown	foundationPlace	Nashville,_Tennessee	False
Alexis_Valdés	team	Nashville,_Tennessee	False
Zulfikar_Ali_Bhutto	author	Compton,_California	False
Kris_Aquino	starring	Ruben_Studdard	False
Pamela_Anderson	office	Charlotte_Ross	False
Dean_Martin	birthPlace	Detroit	False
Mohammad_Reza_Pahlavi	birthPlace	Holly_Marie_Combs	False
John_Adams	foundationPlace	Chicago	False
Saul_Williams	subsidiary	Ayumi_Hamasaki	False
Sara_Maldonado	award	Sienna_Miller	False
Mary_J._Blige	office	Hamlet,_North_Carolina	False
Poppy_Montgomery	subsidiary	Melbourne	False
Quentin_Tarantino	office	Dublin	False
Rebecca_Budig	deathPlace	Maxine_Bahns	False
Frank_Lloyd_Wright	starring	Duluth,_Minnesota	False
Susan_Lanier	deathPlace	Akron,_Ohio	False
Christina_Aguilera	foundationPlace	Mario_López	False
James_Monroe	deathPlace	Branson,_Missouri	False
Samantha_Stosur	deathPlace	Portsmouth	False
Bruce_Springsteen	author	Long_Branch,_New_Jersey	False
Hank_Williams	award	Plains,_Georgia	False
Josip_Broz_Tito	deathPlace	Darius_McCrary	False
Baruch_Spinoza	birthPlace	Fayetteville,_Georgia	False
David_W._Donoho	office	Jamie_Yeo	False
Arthur_Conan_Doyle	subsidiary	Simon_Monjack	False
Curtis_Mayfield	birthPlace	Inglewood,_California	False
Charles_Mingus	starring	Kerr_Smith	False
Manuel_Schwarz	author	Las_Vegas	False
George_Orwell	award	Colombo	False
Janet_Jackson	author	Daniel_Craig	False
Kishore_Kumar	spouse	Los_Angeles	False
Mohammad_Reza_Pahlavi	spouse	Beverly_Hills,_California	False
Muhammad_Ali	starring	Christian_Brando	False
Saddam_Hussein	starring	Beverly_Hills,_California	False
Cara_Black	subsidiary	Christel_Khalil	False
Justin_Siegel	birthPlace	Sienna_Miller	False
Carmine_Giovinazzo	office	Novi_Sad	False
Stevie_Wonder	spouse	Alicante	False
Pierre_Trudeau	team	New_York_City	False
Michael_Jordan	subsidiary	New_York_City	False
Shogo	deathPlace	Ottawa	False
Rebecca_Budig	spouse	Ottawa	False
William_Randolph_Hearst	foundationPlace	New_York_City	False
George_W._Bush	award	Peru,_Indiana	False
Arun_Nayar	award	Beverly_Hills,_California	False
Elsa_Pataky	starring	Hong_Kong	False
Neil_Young	author	El_Centro,_California	False
Redxpress	starring	Santa_Monica,_California	False
Lina_Romay	starring	Houston	False
John_C._Frémont	foundationPlace	Simon_Monjack	False
Ray_Charles	subsidiary	Seattle	False
Harmoni_Everett	office	Geneva	False
Palm,_Inc.	spouse	Matthew_Settle	False
Ben_Indra	office	Stacey_Dash	False
Grihalakshmi	team	Mumbai	False
Tony_Blair	team	Makati	False
Thelonious_Monk	deathPlace	Angham_Mohammad_Ali_Suleiman	False
Big_Fish_Games	award	Montreal	False
Robert_Mitchum	birthPlace	Oxford	False
Sarah_Vaughan	foundationPlace	Liv_Tyler	False
Donna_Summer	author	United_States_of_America	False
SIMULIA	subsidiary	Hannah_Waterman	False
Heath_Ledger	subsidiary	Minsk	False
Ben_Indra	starring	Belgrade	False
Melissa_McKnight	author	Mill_Valley	False
IBM_Internet_Security_Systems	starring	Glendale	False
Franklin_D._Roosevelt	award	Beverly_Hills,_California	False
Johan_Christian_Fabricius	foundationPlace	Jared_Harris	False
Ludwig_Wittgenstein	spouse	Queens	False
John_Wayne	starring	Manisha_Koirala	False
Day_Software_Inc	starring	John_Heard	False
Pervasive_Software	author	The_Hague	False
Robbie_Williams	starring	Lund	False
Ronald_Cheng	deathPlace	Seattle	False
Ness_Wadia	subsidiary	Mountain_View	False
David_Ferrer	foundationPlace	Branson,_Missouri	False
Eminem	starring	Los_Angeles	False
ChoiceBot_Inc.	starring	Samuel_West	False
Chris_Benoit	deathPlace	Dallas	False
Yahoo!	foundationPlace	New_York_City	False
Team_and_Concepts	author	Jamie_Lynn_Spears	False
Navigon	birthPlace	Edinburgh	False
Jay-Z	office	Linköping	False
Jude_Law	spouse	James_Franco	False
Krstarica	birthPlace	Mountain_View	False
Isaac_Hayes	award	Los_Angeles	False
MarkLogic	team	Adam_Kaufman	False
Nas	subsidiary	Kerr_Smith	False
Clark_Gable	spouse	Hidden_Hills,_California	False
Nokia	subsidiary	Memphis,_Tennessee	False
Lime_Wire_LLC	subsidiary	Livonia	False
Mohammad_Reza_Pahlavi	birthPlace	Potsdam	False
Fred_Astaire	office	Madrid	False
Backbone_Entertainment	award	Ted_Harbert	False
Bob_Dylan	author	Marco_Khan	False
Casey_Aldridge	starring	Los_Angeles	False
Hewlett-Packard	starring	Birmingham	False
Stephen_Harper	award	Eriko_Imai	False
Art_Technology_Group	foundationPlace	Victoria,_British_Columbia	False
Woody_Allen	deathPlace	Beverly_Hills,_California	False
Ricky_Groves	foundationPlace	Delaney_Bramlett	False
ChoiceBot_Inc.	author	Kid_Rock	False
Jemima_Khan	author	Oak_Hill,_West_Virginia	False
Nick_Zano	starring	Karviná	False
Jimmy_Carter	award	Barnwell,_South_Carolina	False
John_Ford	starring	Chicago	False
OpenLink_Software	starring	Providence,_Rhode_Island	False
Jerry_Goldsmith	author	Savannah,_Georgia	False
SAP_AG	spouse	Nas	False
Mams_Taylor	foundationPlace	Hendersonville,_Tennessee	False
Hugo_Chávez	deathPlace	Delta_Goodrem	False
Ronald_Cheng	starring	New_York_City	False
Six_Apart	award	Shenzhen	False
SCO_Group	subsidiary	Abigail_Spencer	False
Mel_Tormé	spouse	Salt_Lake_City	False
Max_Mirnyi	foundationPlace	Ottawa	False
Stephen_Dunham	birthPlace	Birmingham,_Alabama	False
John_F._Kennedy	subsidiary	Hannah_Waterman	False
Tim_Henman	team	Davenport,_Iowa	False
John_C._Frémont	spouse	Branson,_Missouri	False
Chiang_Kai-shek	author	Melbourne	False
William_Howard_Taft	starring	Eindhoven	False
Martin_Scorsese	team	Brooklyn	False
Willie_Nelson	office	Saginaw,_Michigan	False
Venus_Williams	subsidiary	Minsk	False
Ringo_Starr	deathPlace	Winterset,_Iowa	False
Olivia_Newton-John	team	Hoboken,_New_Jersey	False
Herbert_Hoover	office	Liverpool	False
Clint_Eastwood	award	Sydney	False
Abraham_Lincoln	award	Boston	False
Stevie_Wonder	foundationPlace	Peru,_Indiana	False
Jeff_Gordon	deathPlace	Providence,_Rhode_Island	False
Olivia_Newton-John	deathPlace	Los_Angeles	False
Hillary_Rodham_Clinton	deathPlace	Omaha,_Nebraska	False
Stevie_Wonder	author	Winterset,_Iowa	False
Avril_Lavigne	birthPlace	Boston	False
James_Brown	starring	Brooklyn	False
Nas	starring	The_Bronx	False
Kelly_Clarkson	author	Lynwood,_California	False
Clint_Eastwood	deathPlace	Long_Branch,_New_Jersey	False
Noam_Chomsky	starring	New_Haven,_Connecticut	False
Mardy_Fish	birthPlace	El_Centro,_California	False
H._P._Lovecraft	award	Toronto	False
Kelly_Clarkson	office	Gary,_Indiana	False
Woodrow_Wilson	foundationPlace	Edina,_Minnesota	False
Bing_Crosby	team	Mumbai	False
Johnny_Cash	author	Los_Angeles	False
Woodrow_Wilson	birthPlace	Fort_Lauderdale,_Florida	False
Tupac_Shakur	foundationPlace	Barranquilla	False
Yoko_Ono	award	Duluth,_Minnesota	False
Kanye_West	foundationPlace	Chicago	False
Robin_Williams	foundationPlace	Dallas	False
Janet_Jackson	birthPlace	Oxford	False
Will.i.am	office	Edinburgh	False
Ozzy_Osbourne	foundationPlace	Newark,_New_Jersey	False
Judy_Garland	subsidiary	Newark,_New_Jersey	False
Pierre_Trudeau	author	Victoria,_British_Columbia	False
Dolly_Parton	award	Dublin	False
Lleyton_Hewitt	deathPlace	Newport_News,_Virginia	False
George_W._Bush	author	Kingsland,_Arkansas	False
Novak_Djokovic	foundationPlace	Portland,_Maine	False
Olivia_Newton-John	author	Syracuse,_New_York	False
Mammootty	spouse	Dublin	False
Justin_Timberlake	birthPlace	Königsberg	False
Cole_Porter	team	Edinburgh	False
Stephen_King	author	Brooklyn	False
David_Lloyd_George	starring	Sydney	False
Dolly_Parton	subsidiary	Belgrade	False
Woodrow_Wilson	author	New_York_City	False
William_McKinley	spouse	Manchester	False
Muhammad_Ali	spouse	Sevierville,_Tennessee	False
Brian_Wilson	deathPlace	Richland_Center,_Wisconsin	False
Cara_Black	award	Saginaw,_Michigan	False
Chiang_Kai-shek	office	Hope,_Arkansas	False
Mitt_Romney	deathPlace	Reykjavík	False
Kelly_Clarkson	author	Norfolk,_Virginia	False
Jimi_Hendrix	starring	Savannah,_Georgia	False
Paul_Haarhuis	subsidiary	Fort_Worth,_Texas	False
Quentin_Tarantino	foundationPlace	San_Francisco	False
Mitt_Romney	office	Dallas	False
John_Lennon	birthPlace	Barranquilla	False
Katy_Perry	team	Oxford	False
Charles_Dickens	starring	Lamar,_Missouri	False
George_W._Bush	office	Saginaw,_Michigan	False
Quentin_Tarantino	birthPlace	Belgrade	False
Mark_Woodforde	team	Seattle	False
Lou_Reed	author	Birmingham,_Alabama	False
Mike_Bryan	author	Louisville,_Kentucky	False
Ella_Fitzgerald	foundationPlace	Los_Angeles	False
Abraham_Lincoln	birthPlace	Boston	False
Jana_Novotná	team	Peru,_Indiana	False
Andre_Agassi	deathPlace	Victoria,_British_Columbia	False
Woodrow_Wilson	spouse	Oxford	False
Bob_Dylan	starring	Atlanta	False
Willie_Nelson	foundationPlace	Motihari	False
