John_Adams	deathPlace	Quincy,_Massachusetts	True
Adam_Smith	deathPlace	Edinburgh	True
Hugo_Chávez	deathPlace	Caracas	True
Chet_Atkins	deathPlace	Nashville,_Tennessee	True
Harry_S._Truman	deathPlace	Kansas_City,_Missouri	True
Kurt_Cobain	deathPlace	Seattle	True
Roscoe_Arbuckle	deathPlace	New_York_City	True
Thelonious_Monk	deathPlace	Englewood,_New_Jersey	True
John_Lee_Hooker	deathPlace	Los_Altos,_California	True
Roald_Dahl	deathPlace	Oxford	True
Robert_Menzies	deathPlace	Melbourne	True
Arthur_Ashe	deathPlace	New_York_City	True
William_McKinley	deathPlace	Buffalo,_New_York	True
Franklin_D._Roosevelt	deathPlace	Warm_Springs,_Georgia	True
L._Sprague_de_Camp	deathPlace	Plano,_Texas	True
Charles_Mingus	deathPlace	Cuernavaca	True
Jefferson_Davis	deathPlace	New_Orleans	True
Fred_Astaire	deathPlace	Los_Angeles	True
Burt_Lancaster	deathPlace	Los_Angeles	True
Tupac_Shakur	deathPlace	Las_Vegas	True
Curtis_Mayfield	deathPlace	Roswell,_Georgia	True
Slobodan_Milošević	deathPlace	The_Hague	True
Bo_Diddley	deathPlace	Archer,_Florida	True
Henry_Wadsworth_Longfellow	deathPlace	Cambridge,_Massachusetts	True
Harold_Lloyd	deathPlace	Beverly_Hills,_California	True
Herbert_Hoover	deathPlace	New_York_City	True
Elizabeth_Taylor	deathPlace	Los_Angeles	True
John_A._Macdonald	deathPlace	Ottawa	True
John_F._Kennedy	deathPlace	Dallas	True
Donna_Summer	deathPlace	Naples,_Florida	True
Heinrich_Gustav_Reichenbach	deathPlace	Hamburg	True
George_Jones	deathPlace	Nashville,_Tennessee	True
John_Wayne	deathPlace	Los_Angeles	True
Herman_Melville	deathPlace	New_York_City	True
Hermann_Göring	deathPlace	Nuremberg	True
Gene_Kelly	deathPlace	Beverly_Hills,_California	True
George_Balanchine	deathPlace	New_York_City	True
James_Monroe	deathPlace	New_York_City	True
Robert_Mitchum	deathPlace	Santa_Barbara,_California	True
Humphrey_Bogart	deathPlace	Los_Angeles	True
Pierre_Trudeau	deathPlace	Montreal	True
Billy_Wilder	deathPlace	Beverly_Hills,_California	True
Walt_Disney	deathPlace	Burbank,_California	True
Jerry_Goldsmith	deathPlace	Beverly_Hills,_California	True
Sarah_Vaughan	deathPlace	Hidden_Hills,_California	True
Miles_Davis	deathPlace	Santa_Monica,_California	True
Kurt_Vonnegut	deathPlace	New_York_City	True
Steve_Jobs	deathPlace	Palo_Alto,_California	True
Louis_IX_of_France	deathPlace	Tunis	True
John_C._Frémont	deathPlace	New_York_City	True
Roy_Orbison	deathPlace	Hendersonville,_Tennessee	True
Anthony_Quinn	deathPlace	Boston	True
John_Diefenbaker	deathPlace	Ottawa	True
Akbar	deathPlace	Agra	True
Ira_Gershwin	deathPlace	Beverly_Hills,_California	True
Josip_Broz_Tito	deathPlace	Ljubljana	True
Benjamin_Harrison	deathPlace	Indianapolis	True
Hank_Williams	deathPlace	Oak_Hill,_West_Virginia	True
Andrew_Johnson	deathPlace	Elizabethton,_Tennessee	True
Jonathan_Swift	deathPlace	Dublin	True
Hal_Roach	deathPlace	Los_Angeles	True
Walt_Whitman	deathPlace	Camden,_New_Jersey	True
Corazon_Aquino	deathPlace	Makati	True
Otis_Redding	deathPlace	Madison,_Wisconsin	True
Richard_Rodgers	deathPlace	New_York_City	True
Kurt_Aland	deathPlace	Münster	True
Johnny_Cash	deathPlace	Nashville,_Tennessee	True
Robert_F._Kennedy	deathPlace	Los_Angeles	True
Philip_K._Dick	deathPlace	Santa_Ana,_California	True
Chris_Benoit	deathPlace	Fayetteville,_Georgia	True
Errol_Flynn	deathPlace	Vancouver	True
Franklin_Pierce	deathPlace	Concord,_New_Hampshire	True
Count_Basie	deathPlace	Hollywood,_Florida	True
Rutherford_B._Hayes	deathPlace	Fremont,_Ohio	True
Edgar_Allan_Poe	deathPlace	Baltimore	True
Gabriel_Lippmann	award	Nobel_Prize_in_Physics	True
William_Golding	award	Nobel_Prize_in_Literature	True
Frans_Eemil_Sillanpää	award	Nobel_Prize_in_Literature	True
Walther_Bothe	award	Nobel_Prize_in_Physics	True
Ivan_Bunin	award	Nobel_Prize_in_Literature	True
Rudyard_Kipling	award	Nobel_Prize_in_Literature	True
Albert_Camus	award	Nobel_Prize_in_Literature	True
Harry_Martinson	award	Nobel_Prize_in_Literature	True
Carlos_Filipe_Ximenes_Belo	award	Nobel_Peace_Prize	True
Henryk_Sienkiewicz	award	Nobel_Prize_in_Literature	True
J._M._Coetzee	award	Nobel_Prize_in_Literature	True
Svante_Arrhenius	award	Nobel_Prize_in_Chemistry	True
Michail_Aleksandrovich_Sholokhov	award	Nobel_Prize_in_Literature	True
Charles_Glover_Barkla	award	Nobel_Prize_in_Physics	True
George_Minot	award	Nobel_Prize_in_Physiology_or_Medicine	True
Wilhelm_Röntgen	award	Nobel_Prize_in_Physics	True
Albert_Einstein	award	Nobel_Prize_in_Physics	True
Anatole_France	award	Nobel_Prize_in_Literature	True
Nils_Gustaf_Dalén	award	Nobel_Prize_in_Physics	True
Shmuel_Yosef_Agnon	award	Nobel_Prize_in_Literature	True
Giosuè_Carducci	award	Nobel_Prize_in_Literature	True
Johannes_Stark	award	Nobel_Prize_in_Physics	True
William_Faulkner	award	Nobel_Prize_in_Literature	True
Gao_Xingjian	award	Nobel_Prize_in_Literature	True
John_Steinbeck	award	Nobel_Prize_in_Literature	True
Jacinto_Benavente	award	Nobel_Prize_in_Literature	True
Wisława_Szymborska	award	Nobel_Prize_in_Literature	True
Halldór_Laxness	award	Nobel_Prize_in_Literature	True
Romain_Rolland	award	Nobel_Prize_in_Literature	True
Gerhart_Hauptmann	award	Nobel_Prize_in_Literature	True
Henry_Dunant	award	Nobel_Peace_Prize	True
Intergovernmental_Panel_on_Climate_Change	award	Nobel_Peace_Prize	True
John_William_Strutt	award	Nobel_Prize_in_Physics	True
Verner_von_Heidenstam	award	Nobel_Prize_in_Literature	True
John_Galsworthy	award	Nobel_Prize_in_Literature	True
George_Seferis	award	Nobel_Prize_in_Literature	True
Theodor_Mommsen	award	Nobel_Prize_in_Literature	True
Heinrich_Böll	award	Nobel_Prize_in_Literature	True
Derek_Walcott	award	Nobel_Prize_in_Literature	True
Czesław_Miłosz	award	Nobel_Prize_in_Literature	True
William_Butler_Yeats	award	Nobel_Prize_in_Literature	True
André_Gide	award	Nobel_Prize_in_Literature	True
Robert_Hofstadter	award	Nobel_Prize_in_Physics	True
James_Franck	award	Nobel_Prize_in_Physics	True
Toni_Morrison	award	Nobel_Prize_in_Literature	True
Yasunari_Kawabata	award	Nobel_Prize_in_Literature	True
Herbert_A._Hauptman	award	Nobel_Prize_in_Chemistry	True
Sigrid_Undset	award	Nobel_Prize_in_Literature	True
Paul_Heyse	award	Nobel_Prize_in_Literature	True
Robert_Andrews_Millikan	award	Nobel_Prize_in_Physics	True
Maurice_Maeterlinck	award	Nobel_Prize_in_Literature	True
Jimmy_Carter	award	Nobel_Peace_Prize	True
Karl_von_Frisch	award	Nobel_Prize_in_Physiology_or_Medicine	True
François_Mauriac	award	Nobel_Prize_in_Literature	True
Thomas_Mann	award	Nobel_Prize_in_Literature	True
Vicente_Aleixandre	award	Nobel_Prize_in_Literature	True
Gabriela_Mistral	award	Nobel_Prize_in_Literature	True
Johannes_Diderik_van_der_Waals	award	Nobel_Prize_in_Physics	True
Władysław_Stanisław_Reymont	award	Nobel_Prize_in_Literature	True
François_Jacob	award	Nobel_Prize_in_Physiology_or_Medicine	True
Antoine_Henri_Becquerel	award	Nobel_Prize_in_Physics	True
José_Saramago	award	Nobel_Prize_in_Literature	True
Luigi_Pirandello	award	Nobel_Prize_in_Literature	True
Arno_Allan_Penzias	award	Nobel_Prize_in_Physics	True
Patrick_White	award	Nobel_Prize_in_Literature	True
Miguel_Ángel_Asturias	award	Nobel_Prize_in_Literature	True
Max_von_Laue	award	Nobel_Prize_in_Physics	True
Sinclair_Lewis	award	Nobel_Prize_in_Literature	True
Roger_Martin_du_Gard	award	Nobel_Prize_in_Literature	True
Herbert_Spencer_Gasser	award	Nobel_Prize_in_Physiology_or_Medicine	True
Joseph_John_Thomson	award	Nobel_Prize_in_Physics	True
Dario_Fo	award	Nobel_Prize_in_Literature	True
International_Atomic_Energy_Agency	award	Nobel_Peace_Prize	True
Juan_Ramón_Jiménez	award	Nobel_Prize_in_Literature	True
Kenzaburō_Ōe	award	Nobel_Prize_in_Literature	True
Elan_Corporation	subsidiary	Athena_Neurosciences	True
Manhattan_Associates	subsidiary	Evant,_Inc.	True
Selectica	subsidiary	Determine_Software	True
Oracle_Corporation	subsidiary	Bharosa	True
Biomet	subsidiary	Interpore	True
Electronic_Arts	subsidiary	Westwood_Studios	True
Yahoo!	subsidiary	Zimbra	True
Adobe_Systems	subsidiary	Macromedia	True
Ascend_Communications	subsidiary	Cascade_Communications	True
Silicon_Graphics,_Inc.	subsidiary	Cray_Research,_Inc.	True
Norfolk_Southern_Railway	subsidiary	Conrail	True
Oracle_Corporation	subsidiary	Interlace_Systems	True
Oracle_Corporation	subsidiary	LogicalApps	True
SunGard	subsidiary	Aceva_Technologies	True
LSI_Corporation	subsidiary	C-Cube_Microsystems	True
SRI_International	subsidiary	PacketHop	True
iUpload	subsidiary	WebPartz	True
Det_Norske_Veritas	subsidiary	Tireno	True
Oracle_Corporation	subsidiary	Tangosol	True
Oracle_Corporation	subsidiary	Demantra	True
EMC_Corporation	subsidiary	Documentum	True
Sun_Microsystems	subsidiary	CenterRun	True
Det_Norske_Veritas	subsidiary	CIBIT	True
Intel_Corporation	subsidiary	Shiva	True
The_Walt_Disney_Company	subsidiary	Fox_Kids	True
Terra_Lycos	subsidiary	Quote.com	True
Neighborhood_America	subsidiary	MOVO_Mobile	True
Yahoo!	subsidiary	BlueLithium	True
Netscape	subsidiary	Collabra_Software	True
Hewlett-Packard	subsidiary	Snapfish	True
Ascend_Communications	subsidiary	Morning_Star_Technologies	True
IBM	subsidiary	Tivoli_Systems,_Inc.	True
BEA_Systems	subsidiary	Plumtree_Software	True
Cisco_Systems,_Inc.	subsidiary	Clarity_Wireless,_Inc	True
Dell	subsidiary	EqualLogic	True
IFM_Renewable_Energy	subsidiary	Pacific_Hydro	True
eBay	subsidiary	Billpoint	True
IBM	subsidiary	IBM_Internet_Security_Systems	True
ABC_Family_Worldwide_Inc.	subsidiary	Television_South	True
Phillips_Electronics_NV	subsidiary	VLSI_Technology	True
Oracle_Corporation	subsidiary	MetaSolv_Software	True
nCircle_Network_Security,_Inc.	subsidiary	Cambia_Security,_Inc.	True
GlaxoSmithKline	subsidiary	Corixa	True
Yahoo!	subsidiary	Overture	True
Infor	subsidiary	Epiphany	True
NBC	subsidiary	Oxygen_media	True
eBay	subsidiary	PayPal	True
Johnson_&_Johnson	subsidiary	Heartport_Inc.	True
TiVo,_Inc.	subsidiary	Strangeberry	True
BMC_Software	subsidiary	Marimba	True
Hewlett-Packard	subsidiary	Logoworks	True
Yahoo!	subsidiary	eGroups	True
Cisco_Systems,_Inc.	subsidiary	Stratum_One	True
ByteMobile	subsidiary	Daedalus	True
Lucent	subsidiary	INS	True
Oracle_Corporation	subsidiary	Hyperion_Solutions	True
Applied_HealthCare	subsidiary	Medicode	True
EchoStar_Communications_Corporation	subsidiary	Sling_Media_Inc.	True
ADC_Telecommunications	subsidiary	LGC_Wireless	True
Mascoma_Corporation	subsidiary	Celsys_Biofuels_Inc.	True
Motorola	subsidiary	Terayon	True
Oracle_Corporation	subsidiary	Sunopsis	True
Oracle_Corporation	subsidiary	Moniforce	True
Platial	subsidiary	Frappr	True
BabyCenter	subsidiary	Maya's_Mom	True
SSA_Global_Technologies	subsidiary	Walker_Interactive_Systems	True
Saba_Software	subsidiary	THINQ_Learning_Solutions	True
Oracle_Corporation	subsidiary	Sigma_Dynamics	True
Oracle_Corporation	subsidiary	Portal_Software	True
Sybase	subsidiary	Mobile_365	True
Oracle_Corporation	subsidiary	SPL_WorldGroup	True
Synopsys	subsidiary	Integrated_Systems_Engineering_AG	True
Oracle_Corporation	subsidiary	Context_Media	True
Emerson_Electric_Company	subsidiary	Cooligy	True
CA_Inc.	subsidiary	Interlink_Computer_Sciences	True
Kaysone_Phomvihane	office	Laos	True
Jelle_Zijlstra	office	Netherlands	True
Pedro_Pires	office	Cape_Verde	True
Golda_Meir	office	Israel	True
José_Manuel_Barroso	office	Portugal	True
Jacques_Chirac	office	France	True
Elisabeth_Domitien	office	Central_African_Republic	True
Kalevi_Sorsa	office	Finland	True
José_Ramos-Horta	office	East_Timor	True
Jean_Chrétien	office	Canada	True
Josip_Broz_Tito	office	Yugoslavia	True
Pierre_Trudeau	office	Canada	True
Gordon_Brown	office	United_Kingdom	True
Manuel_Azaña	office	Spain	True
Gamal_Abdel_Nasser	office	Egypt	True
Mahendra_Chaudhry	office	Fiji	True
Aimo_Cajander	office	Finland	True
José_María_Aznar	office	Spain	True
Gaston_Eyskens	office	Belgium	True
Jean_Casimir-Perier	office	France	True
Saddam_Hussein	office	Iraq	True
Dileita_Mohamed_Dileita	office	Djibouti	True
Ásgeir_Ásgeirsson	office	Iceland	True
Ionatana_Ionatana	office	Tuvalu	True
Kakuei_Tanaka	office	Japan	True
Mahathir_Mohamad	office	Malaysia	True
Poul_Nyrup_Rasmussen	office	Denmark	True
Édith_Cresson	office	France	True
Paul_van_Zeeland	office	Belgium	True
Toshiki_Kaifu	office	Japan	True
Ryutaro_Hashimoto	office	Japan	True
Vazgen_Sargsyan	office	Armenia	True
Wilfried_Martens	office	Belgium	True
Adolphe_Thiers	office	France	True
Pierre_Harmel	office	Belgium	True
Kiichi_Miyazawa	office	Japan	True
Stjepan_Mesić	office	Croatia	True
Keizō_Obuchi	office	Japan	True
Zine_El_Abidine_Ben_Ali	office	Tunisia	True
Ruud_Lubbers	office	Netherlands	True
John_Sparrow_David_Thompson	office	Canada	True
Georges_Pompidou	office	France	True
Ariel_Sharon	office	Israel	True
Barend_Biesheuvel	office	Netherlands	True
Anwar_Sadat	office	Egypt	True
Osachi_Hamaguchi	office	Japan	True
Harold_Wilson	office	United_Kingdom	True
Maria_das_Neves	office	São_Tomé_and_Príncipe	True
Mikhail_Kasyanov	office	Russia	True
Jan_Peter_Balkenende	office	Netherlands	True
Piet_de_Jong	office	Netherlands	True
Mário_Soares	office	Portugal	True
Wilfrid_Laurier	office	Canada	True
Robert_Bond	office	Dominion_of_Newfoundland	True
Jo_Cals	office	Netherlands	True
Bharrat_Jagdeo	office	Guyana	True
Benazir_Bhutto	office	Pakistan	True
P._W._Botha	office	South_Africa	True
Abd_Al-Rahman_Al-Gillani	office	Iraq	True
Abdullah_Ahmad_Badawi	office	Malaysia	True
Abdul-Wahab_Mirjan	office	Iraq	True
Menachem_Begin	office	Israel	True
Louis_Botha	office	South_Africa	True
Tsutomu_Hata	office	Japan	True
Tunku_Abdul_Rahman	office	Malaysia	True
Alec_Douglas-Home	office	United_Kingdom	True
Lauri_Ingman	office	Finland	True
Naji_Shawkat	office	Iraq	True
Baburam_Bhattarai	office	Nepal	True
Abdul_Razak_Hussein	office	Malaysia	True
Yitzhak_Shamir	office	Israel	True
Ahmed_Ouyahia	office	Algeria	True
Jacques_Santer	office	Luxembourg	True
Jean-Luc_Dehaene	office	Belgium	True
Jigme_Thinley	office	Bhutan	True
Ian_Mahinmi	team	Dallas_Mavericks	True
Gerald_Green	team	Boston_Celtics	True
Chris_Kaman	team	Los_Angeles_Clippers	True
Elton_Brand	team	Los_Angeles_Clippers	True
Deron_Williams	team	Utah_Jazz	True
Al_Jefferson	team	Utah_Jazz	True
Tyson_Chandler	team	Chicago_Bulls	True
Martell_Webster	team	Minnesota_Timberwolves	True
Pau_Gasol	team	Memphis_Grizzlies	True
Al_Jefferson	team	Boston_Celtics	True
Metta_World_Peace	team	Houston_Rockets	True
Rasheed_Wallace	team	Atlanta_Hawks	True
Zach_Randolph	team	New_York_Knicks	True
Mike_Dunleavy,_Jr.	team	Indiana_Pacers	True
Channing_Frye	team	New_York_Knicks	True
Kyle_Korver	team	Philadelphia_76ers	True
Gerald_Green	team	Houston_Rockets	True
Raymond_Felton	team	New_York_Knicks	True
Tyson_Chandler	team	Charlotte_Bobcats	True
Gerald_Wallace	team	Charlotte_Bobcats	True
Ray_Allen	team	Boston_Celtics	True
J._R._Smith	team	New_Orleans_Hornets	True
Richard_Jefferson	team	San_Antonio_Spurs	True
Jason_Terry	team	Boston_Celtics	True
Derek_Fisher	team	Dallas_Mavericks	True
Jamal_Crawford	team	New_York_Knicks	True
Ben_Gordon	team	Chicago_Bulls	True
John_Lucas_III	team	Houston_Rockets	True
Derek_Fisher	team	Golden_State_Warriors	True
John_Lucas_III	team	Chicago_Bulls	True
Mike_Miller_(basketball_player)	team	Minnesota_Timberwolves	True
Metta_World_Peace	team	Indiana_Pacers	True
Shaun_Livingston	team	Charlotte_Bobcats	True
Elton_Brand	team	Dallas_Mavericks	True
Shaun_Livingston	team	Los_Angeles_Clippers	True
Derek_Fisher	team	Los_Angeles_Lakers	True
Samuel_Dalembert	team	Sacramento_Kings	True
Dwight_Howard	team	Orlando_Magic	True
Shawn_Marion	team	Miami_Heat	True
Kenyon_Martin	team	Los_Angeles_Clippers	True
Shaun_Livingston	team	Oklahoma_City_Thunder	True
Nazr_Mohammed	team	Oklahoma_City_Thunder	True
Marvin_Williams	team	Atlanta_Hawks	True
Kwame_Brown	team	Los_Angeles_Lakers	True
Andrei_Kirilenko	team	Utah_Jazz	True
Kwame_Brown	team	Golden_State_Warriors	True
Jamal_Crawford	team	Atlanta_Hawks	True
LeBron_James	team	Cleveland_Cavaliers	True
Emeka_Okafor	team	Charlotte_Bobcats	True
Jason_Richardson	team	Charlotte_Bobcats	True
Chauncey_Billups	team	New_York_Knicks	True
Kwame_Brown	team	Detroit_Pistons	True
Nazr_Mohammed	team	Detroit_Pistons	True
Shaun_Livingston	team	Cleveland_Cavaliers	True
Carlos_Delfino	team	Detroit_Pistons	True
Steve_Blake	team	Portland_Trail_Blazers	True
Chris_Kaman	team	Dallas_Mavericks	True
Andris_Biedriņš	team	Golden_State_Warriors	True
Raymond_Felton	team	Portland_Trail_Blazers	True
Chauncey_Billups	team	Detroit_Pistons	True
Luis_Scola	team	Houston_Rockets	True
Kyle_Korver	team	Chicago_Bulls	True
Mike_Miller_(basketball_player)	team	Miami_Heat	True
Monta_Ellis	team	Golden_State_Warriors	True
Andrew_Bynum	team	Los_Angeles_Lakers	True
Steve_Blake	team	Portland_Trail_Blazers	True
Tyler_Hansbrough	team	Indiana_Pacers	True
Carlos_Delfino	team	Houston_Rockets	True
Kevin_Garnett	team	Boston_Celtics	True
Tony_Allen_(basketball)	team	Boston_Celtics	True
Nazr_Mohammed	team	New_York_Knicks	True
Shane_Battier	team	Houston_Rockets	True
Jason_Richardson	team	Orlando_Magic	True
Carlos_Boozer	team	Utah_Jazz	True
Rasheed_Wallace	team	Boston_Celtics	True
Edward_Bulwer-Lytton,_1st_Baron_Lytton	author	Vril	True
Mary_Shelley	author	Frankenstein	True
Michael_F._Flynn	author	Fallen_Angels	True
Kate_Wilhelm	author	Where_Late_the_Sweet_Birds_Sang	True
Walter_Jon_Williams	author	Aristoi	True
Gregory_Keyes	author	A_Calculus_of_Angels	True
Harlan_Ellison	author	Again,_Dangerous_Visions	True
Ian_Stewart	author	Wheelers	True
John_Varley	author	Immodest_Proposals	True
William_Tenn	author	Immodest_Proposals	True
Alexander_Jablokov	author	The_Breath_of_Suspension	True
Ian_R._MacLeod	author	Voyages_by_Starlight	True
Gentry_Lee	author	The_Garden_of_Rama	True
Poul_Anderson	author	The_Boat_of_a_Million_Years	True
Edwin_Balmer	author	When_Worlds_Collide	True
Kurt_Vonnegut	author	Slaughterhouse-Five	True
Kevin_Dilmore	author	Summon_the_Thunder	True
S._Fowler_Wright	author	The_Throne_of_Saturn	True
Jean_Bonnefoy	author	So_Long,_and_Thanks_for_All_the_Fish	True
Iain_Banks	author	Whit	True
Mordecai_Roshwald	author	Level_7	True
Tony_Rothman	author	The_World_Is_Round	True
Gene_Wolfe	author	The_Urth_of_the_New_Sun	True
Brian_Aldiss	author	Non-Stop	True
Walter_M._Miller,_Jr.	author	A_Canticle_for_Leibowitz	True
David_Gerrold	author	When_Harlie_Was_One	True
Frank_Herbert	author	Heretics_of_Dune	True
Kim_Newman	author	Back_in_the_USSA	True
Barry_N._Malzberg	author	Beyond_Apollo	True
H._G._Wells	author	The_Wheels_of_Chance	True
Philip_K._Dick	author	Do_Androids_Dream_of_Electric_Sheep?	True
Joan_Slonczewski	author	A_Door_into_Ocean	True
Joe_Haldeman	author	The_Forever_War	True
Mary_Rosenblum	author	Synthesis_&_Other_Virtual_Realities	True
William_Gibson	author	Neuromancer	True
Daniel_Keyes	author	Flowers_for_Algernon	True
Kim_Stanley_Robinson	author	Fifty_Degrees_Below	True
Ira_Levin	author	This_Perfect_Day	True
Orson_Scott_Card	author	Shadow_of_the_Hegemon	True
Yevgeny_Zamyatin	author	We	True
Larry_Niven	author	The_Integral_Trees	True
Doris_Lessing	author	The_Sentimental_Agents_in_the_Volyen_Empire	True
Robert_Silverberg	author	A_Time_of_Changes	True
Thomas_M._Disch	author	334	True
Robert_Louis_Stevenson	author	Strange_Case_of_Dr_Jekyll_and_Mr_Hyde	True
Rodman_Philbrick	author	The_Last_Book_in_the_Universe	True
Jules_Verne	author	The_Begum's_Fortune	True
Alfred_Bester	author	The_Demolished_Man	True
Robert_Sheckley	author	Options	True
Terry_Pratchett	author	Good_Omens	True
Roger_Zelazny	author	Lord_of_Light	True
Arthur_Conan_Doyle	author	The_Poison_Belt	True
Peter_F._Hamilton	author	The_Neutronium_Alchemist	True
David_Brin	author	The_Postman	True
Michael_Shea	author	Polyphemus	True
Isaac_Asimov	author	The_Caves_of_Steel	True
Garth_Nix	author	Castle	True
Harry_Turtledove	author	Worldwar:_Upsetting_the_Balance	True
Jack_Dann	author	Wandering_Stars	True
C._S._Lewis	author	Out_of_the_Silent_Planet	True
Michael_Swanwick	author	Jack_Faust	True
Neal_Stephenson	author	The_Big_U	True
Russell_Hoban	author	Riddley_Walker	True
C._J._Cherryh	author	The_Collected_Short_Fiction_of_C._J._Cherryh	True
Fritz_Leiber	author	The_Wanderer	True
Mark_Twain	author	A_Connecticut_Yankee_in_King_Arthur's_Court	True
Simon_Clark	author	The_Night_of_the_Triffids	True
John_Barnes	author	Orbital_Resonance	True
Angela_Carter	author	The_Passion_of_New_Eve	True
Carl_Sagan	author	Contact	True
Stanisław_Lem	author	Return_from_the_Stars	True
Kathy_Tyers	author	The_Truce_at_Bakura	True
Stephen_King	author	Carrie	True
Roger_MacBride_Allen	author	The_War_Machine	True
Edwin_Abbott_Abbott	author	Flatland:_A_Romance_of_Many_Dimensions	True
Om_Shanti_Om	starring	Yuvika_Chaudhary	True
The_Aristocats	starring	Hermione_Gingold	True
The_Right_Stuff_(film)	starring	Lance_Henriksen	True
Camp_Rock	starring	Demi_Lovato	True
Edward_Scissorhands	starring	Kathy_Baker	True
A_Hard_Day's_Night_(film)	starring	Maggie_d'Abo	True
A_Hard_Day's_Night_(film)	starring	John_Junkin	True
Ed_Wood_(film)	starring	Jeffrey_Jones	True
Mean_Girls	starring	Lacey_Chabert	True
On_the_Waterfront	starring	Marlon_Brando	True
The_Right_Stuff_(film)	starring	Harry_Shearer	True
High_School_Musical_2	starring	Ashley_Tisdale	True
The_Right_Stuff_(film)	starring	Ed_Harris	True
The_Right_Stuff_(film)	starring	Jeff_Goldblum	True
2012_(film)	starring	Oliver_Platt	True
Camp_Rock	starring	Joe_Jonas	True
2012_(film)	starring	Danny_Glover	True
Godzilla_(1998_film)	starring	Matthew_Broderick	True
Camp_Rock	starring	Maria_Canals_Barrera	True
Mean_Girls	starring	Lizzy_Caplan	True
Clerks	starring	Marilyn_Ghigliotti	True
Predator_(film)	starring	Carl_Weathers	True
2012_(film)	starring	Amanda_Peet	True
Superbad_(film)	starring	Seth_Rogen	True
Last_Action_Hero	starring	Bridgette_Wilson	True
High_School_Musical_2	starring	Lucas_Grabeel	True
Ghostbusters_II	starring	Ernie_Hudson	True
Om_Shanti_Om	starring	Shah_Rukh_Khan	True
Mad_Max	starring	Hugh_Keays-Byrne	True
A_Hard_Day's_Night_(film)	starring	The_Beatles	True
Love_Actually	starring	Colin_Firth	True
Austin_Powers:_The_Spy_Who_Shagged_Me	starring	Robert_Wagner	True
Ghostbusters_II	starring	Bill_Murray	True
The_Aristocats	starring	Sterling_Holloway	True
Ed_Wood_(film)	starring	Lisa_Marie_(actress)	True
Last_Action_Hero	starring	Anthony_Quinn	True
Camp_Rock	starring	Alyson_Stoner	True
The_Right_Stuff_(film)	starring	Barbara_Hershey	True
Austin_Powers:_The_Spy_Who_Shagged_Me	starring	Mike_Myers_(actor)	True
Seven_(film)	starring	Brad_Pitt	True
Kill_Bill	starring	Uma_Thurman	True
Superbad_(film)	starring	Jonah_Hill	True
Last_Action_Hero	starring	Art_Carney	True
Om_Shanti_Om	starring	Deepika_Padukone	True
The_Right_Stuff_(film)	starring	Scott_Glenn	True
Edward_Scissorhands	starring	Alan_Arkin	True
Love_Actually	starring	Laura_Linney	True
A_Hard_Day's_Night_(film)	starring	Wilfrid_Brambell	True
Kill_Bill	starring	Gordon_Liu	True
Clerks	starring	Kevin_Smith	True
A_Hard_Day's_Night_(film)	starring	Paul_McCartney	True
The_Aristocats	starring	Phil_Harris	True
The_Aristocats	starring	Eva_Gabor	True
Godzilla_(1998_film)	starring	Kevin_Dunn	True
Edward_Scissorhands	starring	Dianne_Wiest	True
High_School_Musical_2	starring	Vanessa_Hudgens	True
Ed_Wood_(film)	starring	Patricia_Arquette	True
2012_(film)	starring	Woody_Harrelson	True
Last_Action_Hero	starring	Tom_Noonan	True
Kill_Bill	starring	Lucy_Liu	True
Clerks	starring	Jason_Mewes	True
Love_Actually	starring	Alan_Rickman	True
Austin_Powers:_The_Spy_Who_Shagged_Me	starring	Will_Ferrell	True
Kill_Bill	starring	Daryl_Hannah	True
Mean_Girls	starring	Tina_Fey	True
Ghostbusters_II	starring	Rick_Moranis	True
Mad_Max	starring	Tim_Burns	True
Camp_Rock	starring	Nick_Jonas	True
Predator_(film)	starring	Kevin_Peter_Hall	True
Love_Actually	starring	Hugh_Grant	True
Last_Action_Hero	starring	F._Murray_Abraham	True
Godzilla_(1998_film)	starring	Harry_Shearer	True
Mad_Max	starring	Mel_Gibson	True
Love_Actually	starring	Martine_McCutcheon	True
Predator_(film)	starring	Arnold_Schwarzenegger	True
Kate_Winslet	spouse	Sam_Mendes	True
Jeffrey_Dean_Morgan	spouse	Mary-Louise_Parker	True
Saul_Williams	spouse	Persia_White	True
Peter_Crone	spouse	Maxine_Bahns	True
Howard_K._Stern	spouse	Anna_Nicole_Smith	True
Joshua	spouse	Anna_Tsuchiya	True
Raza_Jaffrey	spouse	Miranda_Raison	True
Jenny_Elam	spouse	Morgan_Paull	True
Shanna_Moakler	spouse	Travis_Barker	True
Andrés_Calamaro	spouse	Julieta_Cardinali	True
Mams_Taylor	spouse	Krista_Allen	True
Naama_Nativ_Settle	spouse	Matthew_Settle	True
Amy_Spanger	spouse	Michael_C._Hall	True
Eminem	spouse	Kimberly_Anne_Scott	True
Manuel_Schwarz	spouse	Ayumi_Hamasaki	True
Robert_Rodriguez	spouse	Rose_McGowan	True
Shogo	spouse	Eriko_Imai	True
Casey_Aldridge	spouse	Jamie_Lynn_Spears	True
Emmanuel_Xuereb	spouse	Stacey_Dash	True
Pollyanna_McIntosh	spouse	Grant_Show	True
Heidi_Klum	spouse	Seal	True
Justin_Siegel	spouse	Emmy_Rossum	True
Lina_Romay	spouse	Jesús_Franco	True
Shraddha_Nigam	spouse	Karan_Singh_Grover	True
Lora_Lee_Ecobelli	spouse	Leo_Burmester	True
Adjowa_Hayes	spouse	Isaac_Hayes	True
Heath_Ledger	spouse	Michelle_Williams	True
Patricio_Borghetti	spouse	Grettell_Valdéz	True
Susan_Lanier	spouse	Delaney_Bramlett	True
Melissa_McKnight	spouse	Matt_LeBlanc	True
Ali_Landry	spouse	Mario_López	True
Samrat_Dahal	spouse	Manisha_Koirala	True
Tamara_Brooks	spouse	Theodore_Bikel	True
Nick_Zano	spouse	Haylie_Duff	True
Jemima_Khan	spouse	Hugh_Grant	True
Aarón_Díaz	spouse	Kate_del_Castillo	True
Katie_Holmes	spouse	Tom_Cruise	True
Tori_Spelling	spouse	Charlie_Shanian	True
Jim_Carrey	spouse	Jenny_McCarthy	True
Karina_Poszar	spouse	Thom_Mathews	True
Michele_Lee	spouse	Jason_Reitman	True
Stephen_Dunham	spouse	Alexondra_Lee	True
Arun_Nayar	spouse	Elizabeth_Hurley	True
Kris_Aquino	spouse	James_Yap	True
Chelsea_Handler	spouse	Ted_Harbert	True
Ben_Indra	spouse	Anna_Faris	True
Craig_Conway	spouse	Jill_Halfpenny	True
Zöe_Salmon	spouse	Gerard_McCarthy	True
Michael_Galeotti	spouse	Bethany_Joy_Lenz-Galeotti	True
Pamela_Anderson	spouse	Kid_Rock	True
Saul_Williams	spouse	Persia_White	True
Ricky_Groves	spouse	Hannah_Waterman	True
Kim_Kardashian	spouse	Kris_Humphries	True
Eva_Green	spouse	Marton_Csokas	True
Emilia_Fox	spouse	Jared_Harris	True
Sebastian_Koch	spouse	Carice_van_Houten	True
Yashu_Ma	spouse	Nicky_Wu	True
Elsa_Pataky	spouse	Adrien_Brody	True
Marc_Anthony	spouse	Jennifer_Lopez	True
James_Belchamber	spouse	Bernard_Archard	True
Diether_Ocampo	spouse	Kristine_Hermosa	True
Nicholas_Tse	spouse	Cecilia_Cheung	True
Joseph_M._Smith	spouse	Jessica_Paré	True
Royston_Langdon	spouse	Liv_Tyler	True
Ashton_Kutcher	spouse	Demi_Moore	True
Poppy_Montgomery	spouse	Adam_Kaufman	True
Steve_McFadden	spouse	Rachel_Sidwell	True
Fahd_Mohamed_Al-Shalabi	spouse	Angham_Mohammad_Ali_Suleiman	True
Tameka_Foster	spouse	Usher	True
Christopher_Knight	spouse	Adrianne_Curry	True
Michael_Goldman	spouse	Charlotte_Ross	True
Ryan_Phillippe	spouse	Abbie_Cornish	True
Will_Arnett	spouse	Amy_Poehler	True
Alexandre_Pato	spouse	Sthefany_Brito	True
Isabella_Leong	spouse	Richard_Li	True
Foldera	foundationPlace	Huntington_Beach	True
Kana	foundationPlace	California	True
SCO_Group	foundationPlace	Santa_Cruz	True
Krstarica	foundationPlace	Belgrade	True
Apago,_Inc.	foundationPlace	Cumming	True
Interwoven	foundationPlace	Sunnyvale	True
Really_Strategies,_Inc.	foundationPlace	Lansdale	True
Silicon_Artists,_Inc.	foundationPlace	Madrid	True
Wipro_Technologies	foundationPlace	India	True
Techexcel	foundationPlace	Lafayette	True
NeXT	foundationPlace	California	True
MonsterCommerce,_LLC	foundationPlace	Belleville	True
Strategy_First	foundationPlace	Montreal	True
SAP_AG	foundationPlace	Mannheim	True
Temenos_Group	foundationPlace	Geneva	True
MailChannels	foundationPlace	Vancouver	True
KickApps	foundationPlace	New_York_City	True
Salesforce.com	foundationPlace	California	True
JetBrains	foundationPlace	Czech_Republic	True
GoldenSource	foundationPlace	New_York_City	True
SIMULIA	foundationPlace	Providence	True
QlikTech	foundationPlace	Lund	True
Cloudspace	foundationPlace	Orlando	True
Picnik	foundationPlace	Seattle	True
Nokia	foundationPlace	Nokia	True
Kineticsware,_Inc.	foundationPlace	Washington	True
Acronis	foundationPlace	United_States_of_America	True
Critical_Path,_Inc.	foundationPlace	San_Francisco	True
Microsoft	foundationPlace	Albuquerque	True
Six_Apart	foundationPlace	San_Francisco	True
Intec_Telecom_Systems	foundationPlace	Woking	True
Xero	foundationPlace	New_Zealand	True
Team_and_Concepts	foundationPlace	Hong_Kong	True
Helmi_Technologies	foundationPlace	Oulu	True
Valve_Corporation	foundationPlace	Kirkland	True
Big_Fish_Games	foundationPlace	Seattle	True
Clickability,_Inc.	foundationPlace	San_Francisco	True
IBM_Internet_Security_Systems	foundationPlace	Atlanta	True
Syntel_Inc.	foundationPlace	Troy	True
Materialise_NV	foundationPlace	Leuven	True
Nemetschek	foundationPlace	Munich	True
Hazent	foundationPlace	Alcalá_de_Henares	True
Digital_Research	foundationPlace	Pacific_Grove	True
Codemasters	foundationPlace	Warwickshire	True
MokaFive	foundationPlace	California	True
Ansoft	foundationPlace	Pittsburgh	True
Condusiv_Technologies	foundationPlace	Glendale	True
Hewlett-Packard	foundationPlace	Palo_Alto	True
IBM	foundationPlace	Endicott	True
Bloombase	foundationPlace	Shenzhen	True
Redxpress	foundationPlace	Portsmouth	True
Mindscape_Group	foundationPlace	Novato	True
Futuremark	foundationPlace	Espoo	True
Softpress	foundationPlace	Oxford	True
VYRE	foundationPlace	Iceland	True
SevOne	foundationPlace	Newark	True
Franz_Inc	foundationPlace	Berkeley	True
RightNow_Technologies	foundationPlace	Bozeman	True
Intuit_Canada	foundationPlace	Edmonton	True
Day_Software_Inc	foundationPlace	Basel	True
Blackbaud	foundationPlace	New_York_City	True
Information_Builders	foundationPlace	United_States_of_America	True
Oracle_Corporation	foundationPlace	California	True
Palm,_Inc.	foundationPlace	United_States_of_America	True
Serena_Software	foundationPlace	California	True
Attachmate	foundationPlace	Bellevue	True
Delrina	foundationPlace	Toronto	True
Lyris	foundationPlace	Berkeley	True
Navigon	foundationPlace	Hamburg	True
Pandemic_Studios	foundationPlace	Santa_Monica	True
impetus_Technologies	foundationPlace	India	True
Financial_Navigator	foundationPlace	Mountain_View	True
Audiokinetic	foundationPlace	Montreal	True
Mindquarry	foundationPlace	Potsdam	True
Spokeo	foundationPlace	Mountain_View	True
Venus_Williams	birthPlace	Lynwood,_California	True
Dr._Dre	birthPlace	Compton,_California	True
Cher	birthPlace	El_Centro,_California	True
David_Lloyd_George	birthPlace	Manchester	True
Abraham_Lincoln	birthPlace	Hodgenville,_Kentucky	True
Yoko_Ono	birthPlace	Tokyo	True
William_Howard_Taft	birthPlace	Cincinnati	True
Woodrow_Wilson	birthPlace	Staunton,_Virginia	True
Mardy_Fish	birthPlace	Edina,_Minnesota	True
Robert_Christgau	birthPlace	New_York_City	True
Victoria_Azarenka	birthPlace	Minsk	True
Charles_Dickens	birthPlace	Portsmouth	True
Ozzy_Osbourne	birthPlace	Birmingham	True
Nelly_Furtado	birthPlace	Victoria,_British_Columbia	True
George_W._Bush	birthPlace	New_Haven,_Connecticut	True
Emmylou_Harris	birthPlace	Birmingham,_Alabama	True
Billy_Joel	birthPlace	New_York_City	True
Pierre_Trudeau	birthPlace	Montreal	True
Justin_Timberlake	birthPlace	Memphis,_Tennessee	True
Kamal_Haasan	birthPlace	Paramakudi	True
Stevie_Wonder	birthPlace	Saginaw,_Michigan	True
Lou_Reed	birthPlace	Brooklyn	True
Robert_De_Niro	birthPlace	New_York_City	True
Muhammad_Ali	birthPlace	Louisville,_Kentucky	True
Nenad_Zimonjić	birthPlace	Belgrade	True
Frank_Lloyd_Wright	birthPlace	Richland_Center,_Wisconsin	True
Jay-Z	birthPlace	New_York_City	True
John_Lennon	birthPlace	Liverpool	True
Usher_(entertainer)	birthPlace	Dallas	True
Michael_Chang	birthPlace	Hoboken,_New_Jersey	True
Arthur_Wellesley,_1st_Duke_of_Wellington	birthPlace	Dublin	True
Jimi_Hendrix	birthPlace	Seattle	True
James_Brown	birthPlace	Barnwell,_South_Carolina	True
Johnny_Mercer	birthPlace	Savannah,_Georgia	True
Björk	birthPlace	Reykjavík	True
Bob_Dylan	birthPlace	Duluth,_Minnesota	True
Andy_Roddick	birthPlace	Omaha,_Nebraska	True
Olivia_Newton-John	birthPlace	Cambridge	True
Clint_Eastwood	birthPlace	San_Francisco	True
Jana_Novotná	birthPlace	Brno	True
Brian_Wilson	birthPlace	Inglewood,_California	True
Noam_Chomsky	birthPlace	Philadelphia	True
H._P._Lovecraft	birthPlace	Providence,_Rhode_Island	True
Mary_J._Blige	birthPlace	The_Bronx	True
Jimmy_Carter	birthPlace	Plains,_Georgia	True
Cole_Porter	birthPlace	Peru,_Indiana	True
Chiang_Kai-shek	birthPlace	Fenghua	True
Bruce_Springsteen	birthPlace	Long_Branch,_New_Jersey	True
Frank_Zappa	birthPlace	Baltimore	True
Kylie_Minogue	birthPlace	Melbourne	True
David_Nalbandian	birthPlace	Unquillo	True
Kofi_Annan	birthPlace	Kumasi	True
William_McKinley	birthPlace	Niles,_Ohio	True
Avril_Lavigne	birthPlace	Belleville,_Ontario	True
Mammootty	birthPlace	Chempu	True
Bing_Crosby	birthPlace	Tacoma,_Washington	True
Mark_Woodforde	birthPlace	Adelaide	True
Stephen_Harper	birthPlace	Toronto	True
Cara_Black	birthPlace	Harare	True
Ray_Charles	birthPlace	Albany,_Georgia	True
Stephen_King	birthPlace	Portland,_Maine	True
Arthur_Conan_Doyle	birthPlace	Edinburgh	True
Martina_Navratilova	birthPlace	Prague	True
Robbie_Williams	birthPlace	Stoke-on-Trent	True
George_Bernard_Shaw	birthPlace	Dublin	True
Neil_Young	birthPlace	Toronto	True
Janet_Jackson	birthPlace	Gary,_Indiana	True
Beck	birthPlace	Los_Angeles	True
Martin_Scorsese	birthPlace	Queens	True
John,_King_of_England	birthPlace	Oxford	True
Woody_Allen	birthPlace	The_Bronx	True
Tony_Blair	birthPlace	Edinburgh	True
Dick_Cheney	birthPlace	Lincoln,_Nebraska	True
Jelena_Janković	birthPlace	Belgrade	True
Donna_Summer	birthPlace	Boston	True
Ray_Charles	deathPlace	Quincy,_Massachusetts	False
Rutherford_B._Hayes	deathPlace	Edinburgh	False
Saddam_Hussein	deathPlace	Caracas	False
Henry_Wadsworth_Longfellow	deathPlace	Nashville,_Tennessee	False
C._S._Lewis	deathPlace	Kansas_City,_Missouri	False
George_Jones	deathPlace	Seattle	False
William_McKinley	deathPlace	New_York_City	False
Henry_Wadsworth_Longfellow	deathPlace	Englewood,_New_Jersey	False
Rutherford_B._Hayes	deathPlace	Los_Altos,_California	False
John_Wayne	deathPlace	Oxford	False
Elizabeth_Taylor	deathPlace	Melbourne	False
Howard_Hughes	deathPlace	New_York_City	False
Adam_Smith	deathPlace	Buffalo,_New_York	False
Pierre_Trudeau	deathPlace	Warm_Springs,_Georgia	False
Tupac_Shakur	deathPlace	Plano,_Texas	False
Akbar	deathPlace	Cuernavaca	False
Clark_Gable	deathPlace	New_Orleans	False
Herbert_Hoover	deathPlace	Los_Angeles	False
Arthur_Ashe	deathPlace	Los_Angeles	False
David_Hume	deathPlace	Las_Vegas	False
James_Stewart	deathPlace	Roswell,_Georgia	False
Woody_Guthrie	deathPlace	The_Hague	False
L._Sprague_de_Camp	deathPlace	Archer,_Florida	False
Gary_Cooper	deathPlace	Cambridge,_Massachusetts	False
Calvin_Coolidge	deathPlace	Beverly_Hills,_California	False
Dizzy_Gillespie	deathPlace	New_York_City	False
Robert_Menzies	deathPlace	Los_Angeles	False
Benjamin_Franklin	deathPlace	Ottawa	False
Kurt_Aland	deathPlace	Dallas	False
Sivaji_Ganesan	deathPlace	Naples,_Florida	False
Hubert_Humphrey	deathPlace	Hamburg	False
Kurt_Cobain	deathPlace	Nashville,_Tennessee	False
Herman_Melville	deathPlace	Los_Angeles	False
Jonathan_Swift	deathPlace	New_York_City	False
Conway_Twitty	deathPlace	Nuremberg	False
Douglas_Adams	deathPlace	Beverly_Hills,_California	False
Billy_Wilder	deathPlace	New_York_City	False
William_Randolph_Hearst	deathPlace	New_York_City	False
Bo_Diddley	deathPlace	Santa_Barbara,_California	False
Billy_Preston	deathPlace	Los_Angeles	False
James_K._Polk	deathPlace	Montreal	False
Clark_Gable	deathPlace	Beverly_Hills,_California	False
Andy_Williams	deathPlace	Burbank,_California	False
Bob_Marley	deathPlace	Beverly_Hills,_California	False
Sammy_Davis,_Jr.	deathPlace	Hidden_Hills,_California	False
Lucille_Ball	deathPlace	Santa_Monica,_California	False
Ella_Fitzgerald	deathPlace	New_York_City	False
James_K._Polk	deathPlace	Palo_Alto,_California	False
Cary_Grant	deathPlace	Tunis	False
James_K._Polk	deathPlace	New_York_City	False
Michael_Jackson	deathPlace	Hendersonville,_Tennessee	False
Slobodan_Milošević	deathPlace	Boston	False
Hal_Roach	deathPlace	Ottawa	False
Chet_Atkins	deathPlace	Agra	False
Hank_Williams	deathPlace	Beverly_Hills,_California	False
John_Lee_Hooker	deathPlace	Ljubljana	False
Frederick_the_Great	deathPlace	Indianapolis	False
Mary_Pickford	deathPlace	Oak_Hill,_West_Virginia	False
John_Lennon	deathPlace	Elizabethton,_Tennessee	False
Humphrey_Bogart	deathPlace	Dublin	False
Errol_Flynn	deathPlace	Los_Angeles	False
Calvin_Coolidge	deathPlace	Camden,_New_Jersey	False
Oscar_Peterson	deathPlace	Makati	False
Billy_Preston	deathPlace	Madison,_Wisconsin	False
Corazon_Aquino	deathPlace	New_York_City	False
Curtis_Mayfield	deathPlace	Münster	False
Billy_Wilder	deathPlace	Nashville,_Tennessee	False
Oscar_Peterson	deathPlace	Los_Angeles	False
George_Jones	deathPlace	Santa_Ana,_California	False
Ludwig_Wittgenstein	deathPlace	Fayetteville,_Georgia	False
Benjamin_Franklin	deathPlace	Vancouver	False
James_Stewart	deathPlace	Concord,_New_Hampshire	False
Ferdinand_von_Mueller	deathPlace	Hollywood,_Florida	False
Eugene_O'Neill	deathPlace	Fremont,_Ohio	False
George_Jones	deathPlace	Baltimore	False
Jaroslav_Seifert	award	Nobel_Prize_in_Physics	False
Andrew_Schally	award	Nobel_Prize_in_Literature	False
William_Henry_Bragg	award	Nobel_Prize_in_Literature	False
José_Echegaray	award	Nobel_Prize_in_Physics	False
International_Atomic_Energy_Agency	award	Nobel_Prize_in_Literature	False
Ahmed_Zewail	award	Nobel_Prize_in_Literature	False
International_Atomic_Energy_Agency	award	Nobel_Prize_in_Literature	False
Andrew_Huxley	award	Nobel_Prize_in_Literature	False
Rudyard_Kipling	award	Nobel_Peace_Prize	False
Niels_Henrik_David_Bohr	award	Nobel_Prize_in_Literature	False
Heike_Kamerlingh_Onnes	award	Nobel_Prize_in_Literature	False
Hendrik_Lorentz	award	Nobel_Prize_in_Chemistry	False
Guglielmo_Marconi	award	Nobel_Prize_in_Literature	False
Eugenio_Montale	award	Nobel_Prize_in_Physics	False
T._S._Eliot	award	Nobel_Prize_in_Physiology_or_Medicine	False
Shirin_Ebadi	award	Nobel_Prize_in_Physics	False
Elias_Canetti	award	Nobel_Prize_in_Physics	False
Andrew_Huxley	award	Nobel_Prize_in_Literature	False
Grazia_Deledda	award	Nobel_Prize_in_Physics	False
Hendrik_Lorentz	award	Nobel_Prize_in_Literature	False
Charles_Thomson_Rees_Wilson	award	Nobel_Prize_in_Literature	False
Seamus_Heaney	award	Nobel_Prize_in_Physics	False
Wangari_Maathai	award	Nobel_Prize_in_Literature	False
Andrew_Huxley	award	Nobel_Prize_in_Literature	False
Charles_Thomson_Rees_Wilson	award	Nobel_Prize_in_Literature	False
Herbert_Spencer_Gasser	award	Nobel_Prize_in_Literature	False
James_Franck	award	Nobel_Prize_in_Literature	False
Max_Planck	award	Nobel_Prize_in_Literature	False
Svante_Arrhenius	award	Nobel_Prize_in_Literature	False
Intergovernmental_Panel_on_Climate_Change	award	Nobel_Prize_in_Literature	False
Jacinto_Benavente	award	Nobel_Peace_Prize	False
Herbert_Spencer_Gasser	award	Nobel_Peace_Prize	False
Pär_Lagerkvist	award	Nobel_Prize_in_Physics	False
William_Henry_Bragg	award	Nobel_Prize_in_Literature	False
François_Jacob	award	Nobel_Prize_in_Literature	False
Grameen_Bank	award	Nobel_Prize_in_Literature	False
Frédéric_Passy	award	Nobel_Prize_in_Literature	False
Frédéric_Passy	award	Nobel_Prize_in_Literature	False
David_Baltimore	award	Nobel_Prize_in_Literature	False
Antoine_Henri_Becquerel	award	Nobel_Prize_in_Literature	False
Andrew_Schally	award	Nobel_Prize_in_Literature	False
David_Baltimore	award	Nobel_Prize_in_Literature	False
Shirin_Ebadi	award	Nobel_Prize_in_Physics	False
Albert_Camus	award	Nobel_Prize_in_Physics	False
Charles_Thomson_Rees_Wilson	award	Nobel_Prize_in_Literature	False
Heike_Kamerlingh_Onnes	award	Nobel_Prize_in_Literature	False
Theodor_Mommsen	award	Nobel_Prize_in_Chemistry	False
Pierre_Curie	award	Nobel_Prize_in_Literature	False
Nils_Gustaf_Dalén	award	Nobel_Prize_in_Literature	False
Sinclair_Lewis	award	Nobel_Prize_in_Physics	False
Herbert_Spencer_Gasser	award	Nobel_Prize_in_Literature	False
Thomas_Mann	award	Nobel_Peace_Prize	False
Rudyard_Kipling	award	Nobel_Prize_in_Physiology_or_Medicine	False
International_Atomic_Energy_Agency	award	Nobel_Prize_in_Literature	False
François_Jacob	award	Nobel_Prize_in_Literature	False
François_Jacob	award	Nobel_Prize_in_Literature	False
Max_von_Laue	award	Nobel_Prize_in_Literature	False
Juan_Ramón_Jiménez	award	Nobel_Prize_in_Physics	False
Heike_Kamerlingh_Onnes	award	Nobel_Prize_in_Literature	False
Harold_Urey	award	Nobel_Prize_in_Physiology_or_Medicine	False
Pablo_Neruda	award	Nobel_Prize_in_Physics	False
Karl_Manne_Georg_Siegbahn	award	Nobel_Prize_in_Literature	False
Albert_Einstein	award	Nobel_Prize_in_Literature	False
Joseph_Brodsky	award	Nobel_Prize_in_Physics	False
Wilhelm_Röntgen	award	Nobel_Prize_in_Literature	False
James_Franck	award	Nobel_Prize_in_Literature	False
George_Minot	award	Nobel_Prize_in_Physics	False
Johannes_Stark	award	Nobel_Prize_in_Literature	False
Ahmed_Zewail	award	Nobel_Prize_in_Literature	False
Herbert_A._Hauptman	award	Nobel_Prize_in_Physiology_or_Medicine	False
Imre_Kertész	award	Nobel_Prize_in_Physics	False
Jimmy_Carter	award	Nobel_Prize_in_Literature	False
Max_Planck	award	Nobel_Peace_Prize	False
Carlos_Filipe_Ximenes_Belo	award	Nobel_Prize_in_Literature	False
Charles_Glover_Barkla	award	Nobel_Prize_in_Literature	False
Kyphon	subsidiary	Athena_Neurosciences	False
Sun_Microsystems	subsidiary	Evant,_Inc.	False
Polycom	subsidiary	Determine_Software	False
Manhattan_Associates	subsidiary	Bharosa	False
Amazon.com	subsidiary	Interpore	False
Yahoo!	subsidiary	Westwood_Studios	False
Oracle_Corporation	subsidiary	Zimbra	False
Verisign	subsidiary	Macromedia	False
NEXX_Systems	subsidiary	Cascade_Communications	False
IBM	subsidiary	Cray_Research,_Inc.	False
Oracle_Corporation	subsidiary	Conrail	False
Compaq	subsidiary	Interlace_Systems	False
Ascend_Communications	subsidiary	LogicalApps	False
St._Jude_Medical	subsidiary	Aceva_Technologies	False
SRI_International	subsidiary	C-Cube_Microsystems	False
Oracle_Corporation	subsidiary	PacketHop	False
Verisign	subsidiary	WebPartz	False
IBM	subsidiary	Tireno	False
Siemens	subsidiary	Tangosol	False
LSI_Corporation	subsidiary	Demantra	False
BMC_Software	subsidiary	Documentum	False
Yahoo!	subsidiary	CenterRun	False
NABI_Biopharmaceuticals	subsidiary	CIBIT	False
Infor	subsidiary	Shiva	False
Norfolk_Southern_Railway	subsidiary	Fox_Kids	False
Oracle_Corporation	subsidiary	Quote.com	False
BEA_Systems	subsidiary	MOVO_Mobile	False
Netscape	subsidiary	BlueLithium	False
Oracle_Corporation	subsidiary	Collabra_Software	False
Ascend_Communications	subsidiary	Snapfish	False
Oracle_Corporation	subsidiary	Morning_Star_Technologies	False
ADC_Telecommunications	subsidiary	Tivoli_Systems,_Inc.	False
IBM	subsidiary	Plumtree_Software	False
Manhattan_Associates	subsidiary	Clarity_Wireless,_Inc	False
NBCUniversal	subsidiary	EqualLogic	False
ADC_Telecommunications	subsidiary	Pacific_Hydro	False
Cadence_Design_Systems	subsidiary	Billpoint	False
EchoStar_Communications_Corporation	subsidiary	IBM_Internet_Security_Systems	False
Oracle_Corporation	subsidiary	Television_South	False
Hewlett-Packard	subsidiary	VLSI_Technology	False
Blue_Coat_Systems	subsidiary	MetaSolv_Software	False
NBCUniversal	subsidiary	Cambia_Security,_Inc.	False
Hewlett-Packard	subsidiary	Corixa	False
eBay	subsidiary	Overture	False
Oracle_Corporation	subsidiary	Epiphany	False
Oracle_Corporation	subsidiary	Oxygen_media	False
Orbital_Sciences_Corporation	subsidiary	PayPal	False
Symantec_Corporation	subsidiary	Heartport_Inc.	False
BEA_Systems	subsidiary	Strangeberry	False
SSA_Global_Technologies	subsidiary	Marimba	False
Cisco_Systems,_Inc.	subsidiary	Logoworks	False
MediaTek	subsidiary	eGroups	False
GE_Healthcare	subsidiary	Stratum_One	False
Oracle_Corporation	subsidiary	Daedalus	False
Oracle_Corporation	subsidiary	INS	False
Elan_Corporation	subsidiary	Hyperion_Solutions	False
Genzyme	subsidiary	Medicode	False
eBay	subsidiary	Sling_Media_Inc.	False
nCircle_Network_Security,_Inc.	subsidiary	LGC_Wireless	False
AOL	subsidiary	Celsys_Biofuels_Inc.	False
TiVo,_Inc.	subsidiary	Terayon	False
IBM	subsidiary	Sunopsis	False
Neighborhood_America	subsidiary	Moniforce	False
Borland	subsidiary	Frappr	False
Biomet	subsidiary	Maya's_Mom	False
Oracle_Corporation	subsidiary	Walker_Interactive_Systems	False
ByteMobile	subsidiary	THINQ_Learning_Solutions	False
IBM	subsidiary	Sigma_Dynamics	False
Electronic_Arts	subsidiary	Portal_Software	False
Dell	subsidiary	Mobile_365	False
Hewlett-Packard	subsidiary	SPL_WorldGroup	False
Penn_Central_Transportation_Company	subsidiary	Integrated_Systems_Engineering_AG	False
Sybase	subsidiary	Context_Media	False
Ascend_Communications	subsidiary	Cooligy	False
Cisco_Systems,_Inc.	subsidiary	Interlink_Computer_Sciences	False
Eisaku_Satō	office	Laos	False
Saddam_Hussein	office	Netherlands	False
Louis_Botha	office	Cape_Verde	False
Kalevi_Sorsa	office	Israel	False
Ruud_Lubbers	office	Portugal	False
Vazgen_Sargsyan	office	France	False
Jean_Chrétien	office	Central_African_Republic	False
Golda_Meir	office	Finland	False
Kalevi_Sorsa	office	East_Timor	False
Edward_Heath	office	Canada	False
Jomo_Kenyatta	office	Yugoslavia	False
Vladimír_Špidla	office	Canada	False
Anton_Rop	office	United_Kingdom	False
Dom_Mintoff	office	Spain	False
Jacques_Chirac	office	Egypt	False
Eisaku_Satō	office	Fiji	False
George_Papandreou	office	Finland	False
Nuri_as-Said	office	Spain	False
Wilfrid_Laurier	office	Belgium	False
Jelle_Zijlstra	office	France	False
Louis_Botha	office	Iraq	False
Wim_Kok	office	Djibouti	False
Joaquim_Rafael_Branco	office	Iceland	False
Aimo_Cajander	office	Tuvalu	False
Vladimír_Špidla	office	Japan	False
Maria_das_Neves	office	Malaysia	False
Stjepan_Mesić	office	Denmark	False
Kalevi_Sorsa	office	France	False
H._H._Asquith	office	Belgium	False
Barend_Biesheuvel	office	Japan	False
Kalevi_Sorsa	office	Japan	False
Mark_Eyskens	office	Armenia	False
H._H._Asquith	office	Belgium	False
Gaston_Eyskens	office	France	False
Hafez_al-Assad	office	Belgium	False
Mark_Eyskens	office	Japan	False
Anwar_Sadat	office	Croatia	False
Paul-Henri_Spaak	office	Japan	False
Harold_Wilson	office	Tunisia	False
George_Papandreou	office	Netherlands	False
Mari_Alkatiri	office	Canada	False
John_Abbott	office	France	False
Maria_das_Neves	office	Israel	False
Menachem_Begin	office	Netherlands	False
Rolandas_Paksas	office	Egypt	False
Joop_den_Uyl	office	Japan	False
Morihiro_Hosokawa	office	United_Kingdom	False
Aimo_Cajander	office	São_Tomé_and_Príncipe	False
Jacques_Chirac	office	Russia	False
Abdullah_Ahmad_Badawi	office	Netherlands	False
Paul-Henri_Spaak	office	Netherlands	False
Robert_Borden	office	Portugal	False
Martti_Miettunen	office	Canada	False
Kwame_Nkrumah	office	Dominion_of_Newfoundland	False
Kakuei_Tanaka	office	Netherlands	False
Barend_Biesheuvel	office	Guyana	False
Jean-Pierre_Raffarin	office	Pakistan	False
Jean-Pierre_Raffarin	office	South_Africa	False
Anders_Fogh_Rasmussen	office	Iraq	False
Elisabeth_Domitien	office	Malaysia	False
Martti_Miettunen	office	Iraq	False
Alec_Douglas-Home	office	Israel	False
Vladimír_Špidla	office	South_Africa	False
Saddam_Hussein	office	Japan	False
Anders_Fogh_Rasmussen	office	Malaysia	False
Willem_Drees	office	United_Kingdom	False
Wilfrid_Laurier	office	Finland	False
Josip_Broz_Tito	office	Iraq	False
François_Tombalbaye	office	Nepal	False
Robert_Borden	office	Malaysia	False
Wim_Kok	office	Israel	False
Laurent_Fabius	office	Algeria	False
Kiichi_Miyazawa	office	Luxembourg	False
Laurent_Fabius	office	Belgium	False
Margaret_Thatcher	office	Bhutan	False
Tayshaun_Prince	team	Dallas_Mavericks	False
Shaun_Livingston	team	Boston_Celtics	False
Kwame_Brown	team	Los_Angeles_Clippers	False
Mike_Miller_(basketball_player)	team	Los_Angeles_Clippers	False
Pau_Gasol	team	Utah_Jazz	False
Nazr_Mohammed	team	Utah_Jazz	False
Mike_Miller_(basketball_player)	team	Chicago_Bulls	False
Deron_Williams	team	Minnesota_Timberwolves	False
Derek_Fisher	team	Memphis_Grizzlies	False
Metta_World_Peace	team	Boston_Celtics	False
Kenyon_Martin	team	Houston_Rockets	False
Dwight_Howard	team	Atlanta_Hawks	False
Jason_Terry	team	New_York_Knicks	False
Pau_Gasol	team	Indiana_Pacers	False
Shaun_Livingston	team	New_York_Knicks	False
LeBron_James	team	Philadelphia_76ers	False
Ian_Mahinmi	team	Houston_Rockets	False
Kwame_Brown	team	New_York_Knicks	False
Shane_Battier	team	Charlotte_Bobcats	False
Ben_Gordon	team	Charlotte_Bobcats	False
John_Lucas_III	team	Boston_Celtics	False
Derek_Fisher	team	New_Orleans_Hornets	False
Monta_Ellis	team	San_Antonio_Spurs	False
Steve_Blake	team	Boston_Celtics	False
Mike_Miller_(basketball_player)	team	Dallas_Mavericks	False
Metta_World_Peace	team	New_York_Knicks	False
Charlie_Villanueva	team	Chicago_Bulls	False
David_Lee_(basketball)	team	Houston_Rockets	False
Deron_Williams	team	Golden_State_Warriors	False
Richard_Jefferson	team	Chicago_Bulls	False
Raymond_Felton	team	Minnesota_Timberwolves	False
Andrei_Kirilenko	team	Indiana_Pacers	False
Andrei_Kirilenko	team	Charlotte_Bobcats	False
Carlos_Boozer	team	Dallas_Mavericks	False
Tyson_Chandler	team	Los_Angeles_Clippers	False
Jason_Terry	team	Los_Angeles_Lakers	False
Raymond_Felton	team	Sacramento_Kings	False
Pau_Gasol	team	Orlando_Magic	False
Dwight_Howard	team	Miami_Heat	False
Rasheed_Wallace	team	Los_Angeles_Clippers	False
Elton_Brand	team	Oklahoma_City_Thunder	False
Amir_Johnson	team	Oklahoma_City_Thunder	False
Gerald_Green	team	Atlanta_Hawks	False
Chris_Kaman	team	Los_Angeles_Lakers	False
Kwame_Brown	team	Utah_Jazz	False
Nazr_Mohammed	team	Golden_State_Warriors	False
Ian_Mahinmi	team	Atlanta_Hawks	False
Carmelo_Anthony	team	Cleveland_Cavaliers	False
Shane_Battier	team	Charlotte_Bobcats	False
Martell_Webster	team	Charlotte_Bobcats	False
Andris_Biedriņš	team	New_York_Knicks	False
Chris_Kaman	team	Detroit_Pistons	False
Jamal_Crawford	team	Detroit_Pistons	False
Mike_Dunleavy,_Jr.	team	Cleveland_Cavaliers	False
Steve_Blake	team	Detroit_Pistons	False
Nazr_Mohammed	team	Portland_Trail_Blazers	False
Kwame_Brown	team	Dallas_Mavericks	False
Kyle_Korver	team	Golden_State_Warriors	False
Andrew_Bynum	team	Portland_Trail_Blazers	False
Ian_Mahinmi	team	Detroit_Pistons	False
Tyson_Chandler	team	Houston_Rockets	False
Tayshaun_Prince	team	Chicago_Bulls	False
Gerald_Green	team	Miami_Heat	False
Shane_Battier	team	Golden_State_Warriors	False
Nazr_Mohammed	team	Los_Angeles_Lakers	False
Carlos_Boozer	team	Portland_Trail_Blazers	False
Gerald_Wallace	team	Indiana_Pacers	False
J._R._Smith	team	Houston_Rockets	False
Derek_Fisher	team	Boston_Celtics	False
Mike_Miller_(basketball_player)	team	Boston_Celtics	False
Kwame_Brown	team	New_York_Knicks	False
Shaun_Livingston	team	Houston_Rockets	False
Chris_Bosh	team	Orlando_Magic	False
Luis_Scola	team	Utah_Jazz	False
Shaun_Livingston	team	Boston_Celtics	False
Peter_F._Hamilton	author	Vril	False
Vernor_Vinge	author	Frankenstein	False
Gentry_Lee	author	Fallen_Angels	False
Cordwainer_Smith	author	Where_Late_the_Sweet_Birds_Sang	False
William_Rollo	author	Aristoi	False
David_Gerrold	author	A_Calculus_of_Angels	False
Kurt_Vonnegut	author	Again,_Dangerous_Visions	False
Stanisław_Lem	author	Wheelers	False
S._Fowler_Wright	author	Wizard	False
Philip_Wylie	author	Immodest_Proposals	False
Alan_E._Nourse	author	The_Breath_of_Suspension	False
Jean_Bonnefoy	author	Voyages_by_Starlight	False
Edwin_Balmer	author	The_Garden_of_Rama	False
John_Wyndham	author	The_Boat_of_a_Million_Years	False
Harlan_Ellison	author	When_Worlds_Collide	False
Gentry_Lee	author	Slaughterhouse-Five	False
Poul_Anderson	author	Summon_the_Thunder	False
Karel_Čapek	author	The_Throne_of_Saturn	False
Isaac_Asimov	author	So_Long,_and_Thanks_for_All_the_Fish	False
Thomas_M._Disch	author	Whit	False
Roger_Zelazny	author	Level_7	False
Gardner_Dozois	author	The_World_Is_Round	False
Cordwainer_Smith	author	The_Urth_of_the_New_Sun	False
Tanith_Lee	author	Non-Stop	False
Philip_Wylie	author	A_Canticle_for_Leibowitz	False
Virginia_DeMarce	author	When_Harlie_Was_One	False
Carl_Sagan	author	Heretics_of_Dune	False
China_Miéville	author	Back_in_the_USSA	False
Jerry_Pournelle	author	Beyond_Apollo	False
Terry_Pratchett	author	The_Wheels_of_Chance	False
Kurt_Vonnegut	author	Do_Androids_Dream_of_Electric_Sheep?	False
Cordwainer_Smith	author	A_Door_into_Ocean	False
John_Thomas_Sladek	author	The_Forever_War	False
Stanisław_Lem	author	Synthesis_&_Other_Virtual_Realities	False
Edwin_Abbott_Abbott	author	Neuromancer	False
E._E._Smith	author	Flowers_for_Algernon	False
Douglas_Adams	author	Fifty_Degrees_Below	False
Kim_Newman	author	This_Perfect_Day	False
Jonathan_Lethem	author	Shadow_of_the_Hegemon	False
Hermann_Hesse	author	We	False
S._Fowler_Wright	author	The_Integral_Trees	False
William_Rollo	author	The_Sentimental_Agents_in_the_Volyen_Empire	False
Eric_Flint	author	A_Time_of_Changes	False
Ian_Stewart	author	334	False
Douglas_Adams	author	Strange_Case_of_Dr_Jekyll_and_Mr_Hyde	False
A._E._van_Vogt	author	The_Last_Book_in_the_Universe	False
Alexander_Jablokov	author	The_Begum's_Fortune	False
E._E._Smith	author	The_Demolished_Man	False
Tony_Rothman	author	Options	False
Alfred_Bester	author	Good_Omens	False
William_Gibson	author	Lord_of_Light	False
John_Brunner	author	The_Poison_Belt	False
Janet_Asimov	author	The_Neutronium_Alchemist	False
Vernor_Vinge	author	The_Postman	False
Gardner_Dozois	author	Polyphemus	False
Bruce_Sterling	author	The_Caves_of_Steel	False
Yevgeny_Zamyatin	author	Castle	False
Angela_Carter	author	Worldwar:_Upsetting_the_Balance	False
Piers_Anthony	author	Wandering_Stars	False
Stephen_Baxter	author	Out_of_the_Silent_Planet	False
Garth_Nix	author	Jack_Faust	False
Thomas_M._Disch	author	The_Big_U	False
Michael_F._Flynn	author	Riddley_Walker	False
John_Thomas_Sladek	author	The_Collected_Short_Fiction_of_C._J._Cherryh	False
Marge_Piercy	author	The_Wanderer	False
Greg_Bear	author	A_Connecticut_Yankee_in_King_Arthur's_Court	False
Larry_Niven	author	The_Night_of_the_Triffids	False
Mordecai_Roshwald	author	Orbital_Resonance	False
Cordwainer_Smith	author	The_Passion_of_New_Eve	False
Fritz_Leiber	author	Contact	False
John_Brunner	author	Return_from_the_Stars	False
Dan_Simmons	author	The_Truce_at_Bakura	False
Doris_Lessing	author	Carrie	False
Fritz_Leiber	author	The_War_Machine	False
Philip_K._Dick	author	Flatland:_A_Romance_of_Many_Dimensions	False
The_Right_Stuff_(film)	starring	Yuvika_Chaudhary	False
Ghostbusters_II	starring	Hermione_Gingold	False
Kill_Bill	starring	Lance_Henriksen	False
The_Right_Stuff_(film)	starring	Demi_Lovato	False
Superbad_(film)	starring	Kathy_Baker	False
Last_Action_Hero	starring	Maggie_d'Abo	False
Austin_Powers:_The_Spy_Who_Shagged_Me	starring	John_Junkin	False
A_Hard_Day's_Night_(film)	starring	Jeffrey_Jones	False
A_Hard_Day's_Night_(film)	starring	Lacey_Chabert	False
Mad_Max	starring	Marlon_Brando	False
Clerks	starring	Harry_Shearer	False
Edward_Scissorhands	starring	Ashley_Tisdale	False
Camp_Rock	starring	Ed_Harris	False
High_School_Musical_2	starring	Jeff_Goldblum	False
The_Aristocats	starring	Oliver_Platt	False
Kill_Bill	starring	Joe_Jonas	False
Love_Actually	starring	Danny_Glover	False
On_the_Waterfront	starring	Matthew_Broderick	False
Edward_Scissorhands	starring	Maria_Canals_Barrera	False
Austin_Powers:_The_Spy_Who_Shagged_Me	starring	Lizzy_Caplan	False
Mad_Max	starring	Marilyn_Ghigliotti	False
Camp_Rock	starring	Carl_Weathers	False
Predator_(film)	starring	Amanda_Peet	False
Godzilla_(1998_film)	starring	Seth_Rogen	False
A_Hard_Day's_Night_(film)	starring	Bridgette_Wilson	False
2012_(film)	starring	Lucas_Grabeel	False
Ed_Wood_(film)	starring	Ernie_Hudson	False
Mad_Max	starring	Shah_Rukh_Khan	False
Camp_Rock	starring	Hugh_Keays-Byrne	False
Camp_Rock	starring	The_Beatles	False
Mad_Max	starring	Colin_Firth	False
Last_Action_Hero	starring	Robert_Wagner	False
Camp_Rock	starring	Bill_Murray	False
Camp_Rock	starring	Sterling_Holloway	False
Kill_Bill	starring	Lisa_Marie_(actress)	False
Om_Shanti_Om	starring	Anthony_Quinn	False
2012_(film)	starring	Alyson_Stoner	False
2012_(film)	starring	Barbara_Hershey	False
The_Right_Stuff_(film)	starring	Mike_Myers_(actor)	False
Camp_Rock	starring	Brad_Pitt	False
Om_Shanti_Om	starring	Uma_Thurman	False
Clerks	starring	Jonah_Hill	False
2012_(film)	starring	Art_Carney	False
Love_Actually	starring	Deepika_Padukone	False
Last_Action_Hero	starring	Scott_Glenn	False
Mean_Girls	starring	Alan_Arkin	False
The_Aristocats	starring	Laura_Linney	False
Love_Actually	starring	Wilfrid_Brambell	False
Clerks	starring	Gordon_Liu	False
Love_Actually	starring	Kevin_Smith	False
2012_(film)	starring	Paul_McCartney	False
Om_Shanti_Om	starring	Phil_Harris	False
Mad_Max	starring	Eva_Gabor	False
Mad_Max	starring	Kevin_Dunn	False
Camp_Rock	starring	Dianne_Wiest	False
A_Hard_Day's_Night_(film)	starring	Vanessa_Hudgens	False
Last_Action_Hero	starring	Patricia_Arquette	False
The_Aristocats	starring	Woody_Harrelson	False
Clerks	starring	Tom_Noonan	False
2012_(film)	starring	Lucy_Liu	False
Love_Actually	starring	Jason_Mewes	False
A_Hard_Day's_Night_(film)	starring	Alan_Rickman	False
The_Aristocats	starring	Will_Ferrell	False
Love_Actually	starring	Daryl_Hannah	False
Ed_Wood_(film)	starring	Tina_Fey	False
Godzilla_(1998_film)	starring	Rick_Moranis	False
Edward_Scissorhands	starring	Tim_Burns	False
Superbad_(film)	starring	Nick_Jonas	False
Mad_Max	starring	Kevin_Peter_Hall	False
Mean_Girls	starring	Hugh_Grant	False
The_Right_Stuff_(film)	starring	F._Murray_Abraham	False
2012_(film)	starring	Harry_Shearer	False
Edward_Scissorhands	starring	Mel_Gibson	False
Mad_Max	starring	Martine_McCutcheon	False
A_Hard_Day's_Night_(film)	starring	Arnold_Schwarzenegger	False
Pamela_Anderson	spouse	Sam_Mendes	False
David_W._Donoho	spouse	Mary-Louise_Parker	False
Lee_Ryan	spouse	Persia_White	False
Fahd_Mohamed_Al-Shalabi	spouse	Maxine_Bahns	False
Heath_Ledger	spouse	Anna_Nicole_Smith	False
Lora_Lee_Ecobelli	spouse	Anna_Tsuchiya	False
Melanie_Shepherd	spouse	Miranda_Raison	False
Christopher_Knight	spouse	Morgan_Paull	False
Craig_Conway	spouse	Travis_Barker	False
Manuel_Schwarz	spouse	Julieta_Cardinali	False
Tony_Parker	spouse	Krista_Allen	False
Peter_Crone	spouse	Matthew_Settle	False
Charlie_Sheen	spouse	Michael_C._Hall	False
Pollyanna_McIntosh	spouse	Kimberly_Anne_Scott	False
Diether_Ocampo	spouse	Ayumi_Hamasaki	False
Joseph_M._Smith	spouse	Rose_McGowan	False
Harmoni_Everett	spouse	Eriko_Imai	False
Mary_Barto	spouse	Jamie_Lynn_Spears	False
Heather_Khan	spouse	Stacey_Dash	False
Stephen_Dunham	spouse	Grant_Show	False
Susannah_Harker	spouse	Seal	False
Jack_White	spouse	Emmy_Rossum	False
Ricky_Groves	spouse	Jesús_Franco	False
Damian_Gabrielle	spouse	Karan_Singh_Grover	False
Carmine_Giovinazzo	spouse	Leo_Burmester	False
Mylène_Jampanoï	spouse	Isaac_Hayes	False
Craig_Conway	spouse	Michelle_Williams	False
Ricky_Groves	spouse	Grettell_Valdéz	False
Adjowa_Hayes	spouse	Delaney_Bramlett	False
Nicholas_Tse	spouse	Matt_LeBlanc	False
Sebastian_Koch	spouse	Mario_López	False
Kevin_Federline	spouse	Manisha_Koirala	False
Amy_Spanger	spouse	Theodore_Bikel	False
Tameka_Foster	spouse	Haylie_Duff	False
Tameka_Foster	spouse	Hugh_Grant	False
Naama_Nativ_Settle	spouse	Kate_del_Castillo	False
Kelis	spouse	Tom_Cruise	False
Isabella_Leong	spouse	Charlie_Shanian	False
Jade_Duell	spouse	Jenny_McCarthy	False
Tamara_Brooks	spouse	Thom_Mathews	False
Craig_Conway	spouse	Jason_Reitman	False
Shaun_O'Brien	spouse	Alexondra_Lee	False
Robert_Rodriguez	spouse	Elizabeth_Hurley	False
Manuel_Schwarz	spouse	James_Yap	False
Stephen_Dunham	spouse	Ted_Harbert	False
Tony_Parker	spouse	Anna_Faris	False
Emma_McAllister	spouse	Jill_Halfpenny	False
Charlie_Sheen	spouse	Gerard_McCarthy	False
Marc_Anthony	spouse	Bethany_Joy_Lenz-Galeotti	False
Simone_Sestito	spouse	Kid_Rock	False
Scarlett_Johansson	spouse	Persia_White	False
Heidi_Klum	spouse	Hannah_Waterman	False
Tori_Spelling	spouse	Kris_Humphries	False
Tony_Parker	spouse	Marton_Csokas	False
Michael_Goldman	spouse	Jared_Harris	False
Ronald_Cheng	spouse	Carice_van_Houten	False
Saul_Williams	spouse	Nicky_Wu	False
Ryan_Phillippe	spouse	Adrien_Brody	False
Rihanna	spouse	Jennifer_Lopez	False
Stephen_Dunham	spouse	Bernard_Archard	False
Kevin_Federline	spouse	Kristine_Hermosa	False
Karina_Poszar	spouse	Cecilia_Cheung	False
Şebnem_Dönmez	spouse	Jessica_Paré	False
Nicholas_Tse	spouse	Liv_Tyler	False
Sara_Maldonado	spouse	Demi_Moore	False
Royston_Langdon	spouse	Adam_Kaufman	False
Jude_Law	spouse	Rachel_Sidwell	False
Kim_Kardashian	spouse	Angham_Mohammad_Ali_Suleiman	False
Luther_Davis	spouse	Usher	False
Poppy_Montgomery	spouse	Adrianne_Curry	False
Kate_Winslet	spouse	Charlotte_Ross	False
Ronald_Cheng	spouse	Abbie_Cornish	False
Melanie_Shepherd	spouse	Amy_Poehler	False
Ahna_O'Reilly	spouse	Sthefany_Brito	False
Michael_Galeotti	spouse	Richard_Li	False
Acronis	foundationPlace	Huntington_Beach	False
Attensity	foundationPlace	California	False
Fujitsu	foundationPlace	Santa_Cruz	False
Rogue_Wave_Software	foundationPlace	Belgrade	False
IntelliCorp	foundationPlace	Cumming	False
Really_Strategies,_Inc.	foundationPlace	Sunnyvale	False
Wipro_Technologies	foundationPlace	Lansdale	False
Danger	foundationPlace	Madrid	False
Cloudspace	foundationPlace	India	False
Yahoo!	foundationPlace	Lafayette	False
Avast_Software_a._s.	foundationPlace	California	False
Siebel_Systems	foundationPlace	Belleville	False
ChoiceBot_Inc.	foundationPlace	Montreal	False
IntelliCorp	foundationPlace	Mannheim	False
Comarch	foundationPlace	Geneva	False
Digital_Research	foundationPlace	Vancouver	False
IBM	foundationPlace	New_York_City	False
Kineticsware,_Inc.	foundationPlace	California	False
Valve_Corporation	foundationPlace	Czech_Republic	False
Ansys	foundationPlace	New_York_City	False
Nokia	foundationPlace	Providence	False
Kineticsware,_Inc.	foundationPlace	Lund	False
Critical_Path,_Inc.	foundationPlace	Orlando	False
Team_and_Concepts	foundationPlace	Seattle	False
OpenLink_Software	foundationPlace	Nokia	False
MontaVista	foundationPlace	Washington	False
SevOne	foundationPlace	United_States_of_America	False
Borland	foundationPlace	San_Francisco	False
LogiSense	foundationPlace	Albuquerque	False
Foldera	foundationPlace	San_Francisco	False
Ansys	foundationPlace	Woking	False
Hyperion_Entertainment	foundationPlace	New_Zealand	False
Uprizer_Labs_LLC	foundationPlace	Hong_Kong	False
Apple_Inc.	foundationPlace	Oulu	False
Microsoft	foundationPlace	Kirkland	False
Critical_Path,_Inc.	foundationPlace	Seattle	False
Palm,_Inc.	foundationPlace	San_Francisco	False
Silicon_Artists,_Inc.	foundationPlace	Atlanta	False
Art_Technology_Group	foundationPlace	Troy	False
MonsterCommerce,_LLC	foundationPlace	Leuven	False
Codemasters	foundationPlace	Munich	False
Serena_Software	foundationPlace	Alcalá_de_Henares	False
Futuremark	foundationPlace	Pacific_Grove	False
LogiSense	foundationPlace	Warwickshire	False
Softdisk	foundationPlace	California	False
Redxpress	foundationPlace	Pittsburgh	False
Strategy_First	foundationPlace	Glendale	False
Franz_Inc	foundationPlace	Palo_Alto	False
Rogue_Wave_Software	foundationPlace	Endicott	False
Angoss	foundationPlace	Shenzhen	False
impetus_Technologies	foundationPlace	Portsmouth	False
MarkLogic	foundationPlace	Novato	False
Softpress	foundationPlace	Espoo	False
Intergraph	foundationPlace	Oxford	False
Symantec_Corporation	foundationPlace	Iceland	False
Team_and_Concepts	foundationPlace	Newark	False
Art_Technology_Group	foundationPlace	Berkeley	False
Team_and_Concepts	foundationPlace	Bozeman	False
Codemasters	foundationPlace	Edmonton	False
Big_Fish_Games	foundationPlace	Basel	False
XITEX_Software	foundationPlace	New_York_City	False
Futuremark	foundationPlace	United_States_of_America	False
Redxpress	foundationPlace	California	False
Day_Software_Inc	foundationPlace	United_States_of_America	False
Spiceworks	foundationPlace	California	False
QlikTech	foundationPlace	Bellevue	False
Applied_Minds	foundationPlace	Toronto	False
Spiceworks	foundationPlace	Berkeley	False
Softdisk	foundationPlace	Hamburg	False
NuSoft_Solutions	foundationPlace	Santa_Monica	False
SevOne	foundationPlace	India	False
crism_consulting	foundationPlace	Mountain_View	False
Angoss	foundationPlace	Montreal	False
Acronis	foundationPlace	Potsdam	False
MetaComCo	foundationPlace	Mountain_View	False
David_Ferrer	birthPlace	Lynwood,_California	False
Mark_Woodforde	birthPlace	Compton,_California	False
John_Lennon	birthPlace	El_Centro,_California	False
Samantha_Stosur	birthPlace	Manchester	False
Mammootty	birthPlace	Hodgenville,_Kentucky	False
Chiang_Kai-shek	birthPlace	Tokyo	False
Jeff_Gordon	birthPlace	Cincinnati	False
Chris_Evert	birthPlace	Staunton,_Virginia	False
Avril_Lavigne	birthPlace	Edina,_Minnesota	False
Tom_Hanks	birthPlace	New_York_City	False
Bill_Clinton	birthPlace	Minsk	False
Arthur_Conan_Doyle	birthPlace	Portsmouth	False
Bob_Dylan	birthPlace	Birmingham	False
Mahesh_Bhupathi	birthPlace	Victoria,_British_Columbia	False
Stevie_Wonder	birthPlace	New_Haven,_Connecticut	False
Rudyard_Kipling	birthPlace	Birmingham,_Alabama	False
Tim_Henman	birthPlace	New_York_City	False
Andy_Roddick	birthPlace	Montreal	False
Harry_S._Truman	birthPlace	Memphis,_Tennessee	False
Venus_Williams	birthPlace	Paramakudi	False
Bryan_Adams	birthPlace	Saginaw,_Michigan	False
Bob_Dylan	birthPlace	Brooklyn	False
Dolly_Parton	birthPlace	New_York_City	False
Cole_Porter	birthPlace	Louisville,_Kentucky	False
Andre_Agassi	birthPlace	Belgrade	False
Tom_Hanks	birthPlace	Richland_Center,_Wisconsin	False
Mammootty	birthPlace	New_York_City	False
Pierre_Trudeau	birthPlace	Liverpool	False
William_Ewart_Gladstone	birthPlace	Dallas	False
Will.i.am	birthPlace	Hoboken,_New_Jersey	False
John_Adams	birthPlace	Dublin	False
John_Coltrane	birthPlace	Seattle	False
Quentin_Tarantino	birthPlace	Barnwell,_South_Carolina	False
Benjamin_Franklin	birthPlace	Savannah,_Georgia	False
George_Orwell	birthPlace	Reykjavík	False
Tony_Blair	birthPlace	Duluth,_Minnesota	False
James_Brown	birthPlace	Omaha,_Nebraska	False
Paul_Haarhuis	birthPlace	Cambridge	False
Ivan_Ljubičić	birthPlace	San_Francisco	False
Mark_Woodforde	birthPlace	Brno	False
Paul_McCartney	birthPlace	Inglewood,_California	False
Lleyton_Hewitt	birthPlace	Philadelphia	False
Oscar_Wilde	birthPlace	Providence,_Rhode_Island	False
Serena_Williams	birthPlace	The_Bronx	False
Jelena_Janković	birthPlace	Plains,_Georgia	False
Arthur_Conan_Doyle	birthPlace	Peru,_Indiana	False
Bob_Dylan	birthPlace	Fenghua	False
Timbaland	birthPlace	Long_Branch,_New_Jersey	False
Oscar_Wilde	birthPlace	Baltimore	False
Bill_Clinton	birthPlace	Melbourne	False
Brian_Wilson	birthPlace	Unquillo	False
Björk	birthPlace	Kumasi	False
Robert_Christgau	birthPlace	Niles,_Ohio	False
Michael_Jordan	birthPlace	Belleville,_Ontario	False
Beyoncé_Knowles	birthPlace	Chempu	False
Chris_Evert	birthPlace	Tacoma,_Washington	False
Venus_Williams	birthPlace	Adelaide	False
Helena_Suková	birthPlace	Toronto	False
William_III_of_England	birthPlace	Harare	False
Justin_Timberlake	birthPlace	Albany,_Georgia	False
Usher_(entertainer)	birthPlace	Portland,_Maine	False
Quentin_Tarantino	birthPlace	Edinburgh	False
Immanuel_Kant	birthPlace	Prague	False
Christina_Aguilera	birthPlace	Stoke-on-Trent	False
Bruce_Springsteen	birthPlace	Dublin	False
Stevie_Wonder	birthPlace	Toronto	False
Martina_Navratilova	birthPlace	Gary,_Indiana	False
Bob_Dylan	birthPlace	Los_Angeles	False
Nas	birthPlace	Queens	False
Billy_Joel	birthPlace	Oxford	False
Tom_Hanks	birthPlace	The_Bronx	False
John_Adams	birthPlace	Edinburgh	False
Max_Mirnyi	birthPlace	Lincoln,_Nebraska	False
Nas	birthPlace	Belgrade	False
Ringo_Starr	birthPlace	Boston	False
